sport,dport,ack_in,ack_out,byte,duration,flow,inbyte,outbyte,inpacket,outpacket,packet,psh_in,psh_out
65485,443,103,102,24903,1000000,1,6499,18404,103,102,205,7,96
65485,443,87,87,21300,1000000,1,5163,16137,87,87,174,3,84
65485,443,86,87,21568,1000000,1,4978,16590,86,87,173,2,85
65485,443,81,82,19626,1000000,1,5045,14581,81,82,163,5,77
65485,443,103,103,25228,1000000,1,6174,19054,103,103,206,4,99
65485,443,71,70,16496,1000000,1,5033,11463,71,70,141,9,62
65485,443,49,46,10756,1000000,1,4448,6308,49,46,95,14,35
65485,443,45,42,10067,1000000,1,3827,6240,45,42,87,11,34
65485,443,45,45,10357,1000000,1,3585,6772,45,45,90,9,37
65485,443,28,28,6704,1000000,1,1778,4926,28,28,56,2,26
65485,443,32,32,7764,1000000,1,1855,5909,32,32,64,1,31
65485,443,48,46,10653,1000000,1,4370,6283,48,46,94,14,35
65485,443,38,38,8496,1000000,1,3080,5416,38,38,76,8,30
65485,443,41,40,9321,1000000,1,3274,6047,41,40,81,8,33
65485,443,32,32,7560,1000000,1,2121,5439,32,32,64,3,29
65485,443,25,26,6246,1000000,1,1489,4757,25,26,51,1,25
65485,443,43,41,9674,1000000,1,3755,5919,43,41,84,11,32
65485,443,49,46,10827,1000000,1,4321,6506,49,46,95,13,36
65485,443,40,40,9369,1000000,1,2990,6379,40,40,80,6,34
65485,443,38,37,8576,1000000,1,3080,5496,38,37,75,8,30
65485,443,46,42,10142,1000000,1,3893,6249,46,42,88,11,35
65485,443,41,41,9343,1000000,1,3242,6101,41,41,82,8,33
65485,443,39,39,8947,1000000,1,2995,5952,39,39,78,7,32
65485,443,36,36,8563,1000000,1,2579,5984,36,36,72,5,32
65485,443,45,41,9777,1000000,1,4081,5696,45,41,86,13,32
65485,443,41,41,9558,1000000,1,2861,6697,41,41,82,5,36
65485,443,36,36,8749,1000000,1,2198,6551,36,36,72,2,34
65485,443,46,44,10490,1000000,1,3663,6827,46,44,90,9,37
65485,443,28,28,6049,1000000,1,2709,3340,29,29,58,9,19
65485,443,35,35,8310,1000000,1,2295,6015,35,35,70,3,32
65485,443,80,80,19260,1000000,1,4840,14420,80,80,160,4,76
65485,443,117,114,27539,1000000,1,8168,19371,117,114,231,14,103
65485,443,100,97,24611,1000000,1,6770,17841,100,97,197,10,92
65485,443,88,89,21878,1000000,1,5042,16836,88,89,177,2,87
65485,443,101,99,24321,1000000,1,6355,17966,101,99,200,7,94
65485,443,96,96,23670,1000000,1,5335,18335,96,96,192,1,95
65485,443,70,71,16484,1000000,1,5110,11374,70,71,141,10,60
65485,443,44,43,10689,1000000,1,2920,7769,44,43,87,4,40
65485,443,42,42,9708,1000000,1,3054,6654,42,42,84,6,36
65485,443,34,34,8071,1000000,1,2471,5600,34,34,68,5,29
65485,443,37,35,8596,1000000,1,2792,5804,37,35,72,6,31
65485,443,49,48,11072,1000000,1,4182,6890,49,48,97,12,38
65485,443,40,40,8976,1000000,1,3176,5800,40,40,80,8,32
65485,443,44,44,10081,1000000,1,3404,6677,44,44,88,8,36
65485,443,64,63,15079,1000000,1,4381,10698,64,63,127,7,57
65485,443,106,107,26360,1000000,1,6320,20040,106,107,213,4,103
65485,443,75,74,17139,1000000,1,5991,11148,75,74,149,15,60
65485,443,101,101,24624,1000000,1,6034,18590,101,101,202,4,97
65485,443,84,83,20228,1000000,1,5346,14882,84,83,167,6,78
65485,443,68,68,16548,1000000,1,3962,12586,68,68,136,2,66
65485,443,32,32,6901,1000000,1,2998,3903,32,32,64,10,22
65485,443,68,66,15581,1000000,1,5069,10512,68,66,134,11,57
65485,443,79,78,18883,1000000,1,5155,13728,79,78,157,7,73
65485,443,105,103,24841,1000000,1,7322,17519,105,103,208,12,93
65485,443,74,74,18120,1000000,1,4147,13973,74,74,148,1,73
65485,443,85,85,20616,1000000,1,5098,15518,85,85,170,4,81
65485,443,88,88,20804,1000000,1,5768,15036,88,88,176,8,80
65485,443,85,85,20306,1000000,1,6023,14283,85,85,170,11,75
65485,443,111,111,27066,1000000,1,6459,20607,111,111,222,3,108
65485,443,89,90,21679,1000000,1,5465,16214,89,90,179,5,85
65485,443,96,95,23493,1000000,1,5728,17765,96,95,191,4,92
65485,443,89,89,21810,1000000,1,4957,16853,89,89,178,1,88
65485,443,101,101,24852,1000000,1,6284,18568,101,101,202,6,95
65485,443,94,93,22529,1000000,1,6521,16008,94,93,187,11,84
65485,443,97,96,22995,1000000,1,6683,16312,97,96,193,11,86
65485,443,38,38,8712,1000000,1,2826,5886,38,38,76,6,32
65485,443,40,40,9084,1000000,1,3049,6035,40,40,80,7,33
65485,443,24,24,5719,1000000,1,1423,4296,24,24,48,1,23
65485,443,19,19,4555,1000000,1,1280,3275,19,19,38,2,17
65485,443,26,26,5640,1000000,1,2293,3347,26,26,52,7,19
65485,443,39,37,8320,1000000,1,3757,4563,39,37,76,13,26
65485,443,20,19,4404,1000000,1,1461,2943,20,19,39,3,16
65485,443,26,26,6044,1000000,1,2190,3854,26,26,52,6,21
65485,443,35,33,7556,1000000,1,3311,4245,35,33,68,11,24
65485,443,31,30,6601,1000000,1,2944,3657,31,30,61,10,21
65485,443,19,19,4350,1000000,1,1407,2943,19,19,38,3,16
65485,443,61,61,14250,1000000,1,4183,10067,61,61,122,7,54
65485,443,49,50,11082,1000000,1,4067,7015,49,50,99,11,39
65485,443,38,38,8808,1000000,1,2687,6121,38,38,76,5,33
65485,443,47,46,10333,1000000,1,4074,6259,47,46,93,12,35
65485,443,24,24,5148,1000000,1,2185,2963,24,24,48,7,17
65485,443,27,26,6003,1000000,1,3048,2955,28,27,55,11,17
65485,443,25,25,5888,1000000,1,1890,3998,25,25,50,4,21
65485,443,38,38,9489,1000000,1,2433,7056,38,38,76,3,36
65485,443,69,70,15703,1000000,1,5679,10024,69,70,139,15,55
65485,443,51,51,12225,1000000,1,3516,8709,51,51,102,6,45
65485,443,46,44,10639,1000000,1,3119,7520,46,44,90,5,40
65485,443,40,40,9763,1000000,1,2541,7222,40,40,80,3,38
65485,443,73,73,17486,1000000,1,4645,12841,73,73,146,5,68
65485,443,92,93,21888,1000000,1,6147,15741,92,93,185,9,84
65485,443,94,95,22452,1000000,1,6092,16360,94,95,189,8,87
65485,443,98,98,23395,1000000,1,6447,16948,98,98,196,9,90
65485,443,113,111,27284,1000000,1,7329,19955,113,111,224,9,104
65485,443,106,106,25618,1000000,1,6693,18925,106,106,212,7,99
65485,443,96,96,23100,1000000,1,5843,17257,96,96,192,5,91
65485,443,92,92,21922,1000000,1,5984,15938,92,92,184,8,84
65485,443,114,114,27488,1000000,1,7359,20129,114,114,228,9,105
65485,443,107,107,25506,1000000,1,6842,18664,107,107,214,8,99
65485,443,86,86,20551,1000000,1,5672,14879,86,86,172,8,79
65485,443,98,98,23364,1000000,1,6193,17171,98,98,196,7,91
65485,443,86,86,20508,1000000,1,5406,15102,86,86,172,6,80
65485,443,76,76,18480,1000000,1,4358,14122,76,76,152,2,74
65485,443,77,77,18402,1000000,1,4793,13609,77,77,154,5,72
65485,443,84,85,20100,1000000,1,5425,14675,84,85,169,7,78
65485,443,81,81,19290,1000000,1,5148,14142,81,81,162,6,75
65485,443,92,90,22304,1000000,1,5373,16931,92,90,182,3,88
65485,443,105,104,25120,1000000,1,7012,18108,105,104,209,10,95
65485,443,101,102,24242,1000000,1,6518,17724,101,102,203,8,94
65485,443,83,82,19934,1000000,1,5244,14690,83,82,165,6,77
65485,443,81,81,19842,1000000,1,4525,15317,81,81,162,1,80
65485,443,81,80,19346,1000000,1,5275,14071,81,80,161,7,74
65485,443,45,44,9884,1000000,1,3871,6013,45,44,89,11,34
65485,443,29,29,7070,1000000,1,1737,5333,29,29,58,1,28
65485,443,34,34,7932,1000000,1,2344,5588,34,34,68,4,30
65485,443,38,38,8635,1000000,1,2846,5789,38,38,76,6,32
65485,443,47,45,10593,1000000,1,3935,6658,47,45,92,11,36
65485,443,44,43,10028,1000000,1,3531,6497,44,43,87,9,35
65485,443,40,40,9084,1000000,1,3049,6035,40,40,80,7,33
65485,443,43,41,9607,1000000,1,3477,6130,43,41,84,9,34
65485,443,43,39,9784,1000000,1,3338,6446,43,39,82,8,34
65485,443,37,37,8497,1000000,1,3026,5471,37,37,74,8,30
65485,443,33,33,7578,1000000,1,2417,5161,33,33,66,5,28
65485,443,43,42,9686,1000000,1,3604,6082,43,42,85,10,33
65485,443,37,34,8498,1000000,1,2772,5726,37,34,71,6,31
65485,443,32,32,7656,1000000,1,1982,5674,32,32,64,2,30
65485,443,48,47,10676,1000000,1,4116,6560,48,47,95,12,36
65485,443,48,48,10860,1000000,1,3759,7101,48,48,96,9,39
65485,443,47,47,10526,1000000,1,3832,6694,47,47,94,10,37
65485,443,28,28,6564,1000000,1,1893,4671,28,28,56,3,25
65485,443,74,74,17772,1000000,1,4504,13268,74,74,148,4,70
65485,443,82,82,20251,1000000,1,4730,15521,82,82,164,2,80
65485,443,90,90,22099,1000000,1,5277,16822,90,90,180,3,88
65485,443,80,80,19368,1000000,1,4713,14655,80,80,160,3,77
65485,443,83,84,19772,1000000,1,5776,13996,83,84,167,10,74
65485,443,26,25,5479,1000000,1,2547,2932,26,25,51,9,17
65485,443,30,29,7111,1000000,1,2001,5110,30,29,59,3,27
65485,443,43,43,9843,1000000,1,3338,6505,43,43,86,8,35
65485,443,38,37,8671,1000000,1,2965,5706,38,37,75,7,31
65485,443,26,25,5664,1000000,1,2039,3625,26,25,51,5,20
65485,443,22,23,5172,1000000,1,1696,3476,22,23,45,4,19
65485,443,63,62,15223,1000000,1,3680,11543,63,62,125,2,60
65485,443,111,110,27082,1000000,1,6975,20107,111,110,221,7,105
65485,443,95,95,23318,1000000,1,5662,17656,95,95,190,4,91
65485,443,105,105,25809,1000000,1,6262,19547,105,105,210,4,101
65485,443,95,95,23006,1000000,1,6055,16951,95,95,190,7,89
65485,443,106,106,26385,1000000,1,6038,20347,106,106,212,2,104
65485,443,117,115,28502,1000000,1,7624,20878,117,115,232,10,106
65485,443,133,133,32981,1000000,1,8790,24191,133,133,266,12,123
65485,443,76,76,18226,1000000,1,5061,13165,76,76,152,7,69
65485,443,44,44,10188,1000000,1,3150,7038,44,44,88,6,38
65485,443,54,53,12183,1000000,1,4325,7858,54,53,107,11,43
65485,443,53,53,12544,1000000,1,3795,8749,53,53,106,7,46
65485,443,54,54,12217,1000000,1,4325,7892,54,54,108,11,43
65485,443,51,50,11762,1000000,1,3921,7841,51,50,101,9,42
65485,443,45,44,10725,1000000,1,2950,7775,45,44,89,4,41
65485,443,46,46,11210,1000000,1,2865,8345,46,46,92,3,43
65485,443,36,36,8424,1000000,1,2452,5972,36,36,72,4,32
65485,443,85,84,19960,1000000,1,6158,13802,85,84,169,12,74
65485,443,100,100,23925,1000000,1,6476,17449,100,100,200,8,92
65485,443,101,100,24391,1000000,1,6022,18369,101,100,201,4,96
65485,443,104,105,25273,1000000,1,6414,18859,104,105,209,6,99
65485,443,119,122,28954,1000000,1,7848,21106,119,122,241,10,112
65485,443,94,95,23018,1000000,1,5735,17283,94,95,189,5,90
65485,443,112,110,27077,1000000,1,7720,19357,112,110,222,12,100
65485,443,91,91,22861,1000000,1,5760,17101,91,91,182,6,86
65485,443,82,81,19981,1000000,1,4555,15426,82,81,163,1,80
65485,443,129,128,31524,1000000,1,8133,23391,129,128,257,9,121
65485,443,109,109,25796,1000000,1,7319,18477,109,109,218,11,98
65485,443,77,77,18782,1000000,1,4468,14314,77,77,154,2,75
65485,443,89,87,21433,1000000,1,5771,15662,89,87,176,7,82
65485,443,110,110,26731,1000000,1,6762,19969,110,110,220,6,104
65485,443,106,104,24470,1000000,1,7768,16702,106,104,210,16,90
65485,443,94,94,22704,1000000,1,6025,16679,94,94,188,7,88
65485,443,69,68,16523,1000000,1,4647,11876,69,68,137,7,62
65485,443,87,87,21105,1000000,1,5484,15621,87,87,174,6,81
65485,443,87,87,21061,1000000,1,5520,15541,87,87,174,6,82
65485,443,89,88,21635,1000000,1,5529,16106,89,88,177,5,84
65485,443,85,85,20612,1000000,1,5317,15295,85,85,170,5,81
65485,443,107,107,25134,1000000,1,7175,17959,107,107,214,11,96
65485,443,101,100,24253,1000000,1,6419,17834,101,100,201,7,94
65485,443,100,98,23918,1000000,1,6833,17085,100,98,198,11,89
65485,443,100,100,24328,1000000,1,6337,17991,100,100,200,7,93
65485,443,97,96,23720,1000000,1,5540,18180,97,96,193,2,94
65485,443,94,94,23197,1000000,1,6033,17164,94,94,188,7,88
65485,443,82,83,20204,1000000,1,4738,15466,82,83,165,2,81
65485,443,117,118,28241,1000000,1,8260,19981,117,118,235,14,105
65485,443,103,105,24990,1000000,1,6475,18515,103,105,208,7,98
65485,443,92,92,22408,1000000,1,5798,16610,92,92,184,6,86
65485,443,95,95,23366,1000000,1,5845,17521,95,95,190,5,90
65485,443,99,97,23116,1000000,1,7033,16083,99,97,196,13,86
65485,443,106,106,25670,1000000,1,6510,19160,106,106,212,6,100
65485,443,105,105,24267,1000000,1,7738,16529,105,105,210,16,89
65485,443,40,40,9331,1000000,1,3049,6282,40,40,80,7,34
65485,443,26,26,5893,1000000,1,2051,3842,26,26,52,5,21
65485,443,28,28,6300,1000000,1,2274,4026,28,28,56,6,22
65485,443,49,46,10336,1000000,1,4817,5519,49,46,95,17,32
65485,443,29,29,6403,1000000,1,2455,3948,29,29,58,7,22
65485,443,29,28,6573,1000000,1,2340,4233,29,28,57,6,23
65485,443,36,36,8249,1000000,1,2833,5416,36,36,72,7,29
65485,443,26,26,5772,1000000,1,2190,3582,26,26,52,6,20
65485,443,48,46,10323,1000000,1,4497,5826,48,46,94,15,33
65485,443,21,19,4736,1000000,1,1769,2967,21,19,40,5,16
65485,443,31,32,7193,1000000,1,2321,4872,31,32,63,5,27
65485,443,30,29,7004,1000000,1,2267,4737,30,29,59,5,25
65485,443,40,40,8976,1000000,1,3176,5800,40,40,80,8,32
65485,443,35,35,8070,1000000,1,2525,5545,35,35,70,5,30
65485,443,25,26,6107,1000000,1,1350,4757,25,26,51,0,25
65485,443,35,34,8125,1000000,1,2537,5588,35,34,69,5,30
65485,443,36,36,8340,1000000,1,2603,5737,36,36,72,5,31
65485,443,40,39,9171,1000000,1,3081,6090,40,39,79,7,33
65485,443,43,43,9510,1000000,1,3604,5906,43,43,86,10,33
65485,443,43,42,9793,1000000,1,3362,6431,43,42,85,8,35
65485,443,40,40,9084,1000000,1,3049,6035,40,40,80,7,33
65485,443,32,32,7568,1000000,1,2109,5459,32,32,64,3,29
65485,443,28,28,6373,1000000,1,2147,4226,28,28,56,5,23
65485,443,41,41,9342,1000000,1,3115,6227,41,41,82,7,34
65485,443,55,55,12902,1000000,1,3732,9170,55,55,110,6,49
65485,443,107,105,25675,1000000,1,7104,18571,107,105,212,10,97
65485,443,107,107,25731,1000000,1,6703,19028,107,107,214,7,100
65485,443,73,73,17982,1000000,1,3966,14016,73,73,146,0,73
65485,443,88,88,21061,1000000,1,5701,15360,88,88,176,7,81
65485,443,98,99,23602,1000000,1,7023,16579,98,99,197,13,87
65485,443,104,104,24984,1000000,1,6426,18558,104,104,208,6,98
65485,443,101,101,24426,1000000,1,5974,18452,101,101,202,4,97
65485,443,112,112,26894,1000000,1,7132,19762,112,112,224,8,104
65485,443,104,104,25202,1000000,1,6275,18927,104,104,208,5,99
65485,443,102,103,24446,1000000,1,6802,17644,102,103,205,10,93
65485,443,82,81,19579,1000000,1,5190,14389,82,81,163,6,76
65485,443,91,91,22034,1000000,1,5851,16183,91,91,182,7,84
65485,443,94,93,22481,1000000,1,6263,16218,94,93,187,9,85
65485,443,101,102,24925,1000000,1,6034,18891,101,102,203,4,99
65485,443,87,86,21276,1000000,1,4861,16415,87,86,173,1,85
65485,443,112,113,26666,1000000,1,7632,19034,112,113,225,12,101
65485,443,99,99,23912,1000000,1,6525,17387,99,99,198,9,90
65485,443,98,98,23968,1000000,1,6320,17648,98,98,196,8,92
65485,443,97,97,24148,1000000,1,5655,18493,97,97,194,3,95
65485,443,99,99,24381,1000000,1,5831,18550,99,99,198,3,96
65485,443,91,92,22488,1000000,1,5815,16673,91,92,183,7,85
65485,443,85,83,19952,1000000,1,5872,14080,85,83,168,10,75
65485,443,61,61,14250,1000000,1,4183,10067,61,61,122,7,54
65485,443,24,24,5636,1000000,1,1914,3722,25,25,50,4,20
65485,443,48,47,11030,1000000,1,3493,7537,48,47,95,7,41
65485,443,80,80,18860,1000000,1,5380,13480,80,80,160,8,72
65485,443,108,108,26506,1000000,1,6686,19820,108,108,216,6,103
65485,443,130,129,31192,1000000,1,8406,22786,130,129,259,10,120
65485,443,107,108,25578,1000000,1,6957,18621,107,108,215,9,99
65485,443,88,87,21438,1000000,1,5550,15888,88,87,175,6,82
65485,443,121,122,29582,1000000,1,7817,21765,121,122,243,9,113
65485,443,88,88,21514,1000000,1,5546,15968,88,88,176,6,84
65485,443,96,96,23817,1000000,1,5625,18192,96,96,192,3,93
65485,443,93,93,22428,1000000,1,5832,16596,93,93,186,6,87
65485,443,85,85,20095,1000000,1,5769,14326,85,85,170,9,76
65485,443,100,99,23849,1000000,1,6798,17051,100,99,199,10,90
65485,443,86,87,20541,1000000,1,5843,14698,86,87,173,9,78
65485,443,95,95,23193,1000000,1,5801,17392,95,95,190,5,90
65485,443,95,96,22926,1000000,1,5904,17022,95,96,191,6,90
65485,443,108,109,26397,1000000,1,6797,19600,108,109,217,7,103
65485,443,80,80,19533,1000000,1,5118,14415,80,80,160,6,74
65485,443,93,94,22700,1000000,1,5844,16856,93,94,187,6,88
65485,443,102,102,24243,1000000,1,6997,17246,102,102,204,11,92
65485,443,100,98,23763,1000000,1,6333,17430,100,98,198,7,92
65485,443,88,89,21084,1000000,1,5641,15443,88,89,177,7,82
65485,443,99,98,23329,1000000,1,6616,16713,99,98,197,10,89
65485,443,93,93,22134,1000000,1,5923,16211,93,93,186,7,86
65485,443,101,102,24173,1000000,1,6907,17266,101,102,203,11,92
65485,443,86,87,20702,1000000,1,5660,15042,86,87,173,8,79
65485,443,85,85,20719,1000000,1,4995,15724,85,85,170,3,82
65485,443,102,101,24707,1000000,1,6223,18484,102,101,203,5,97
65485,443,92,90,21967,1000000,1,6191,15776,92,90,182,9,83
65485,443,70,69,16556,1000000,1,4832,11724,70,69,139,8,62
65485,443,69,70,16422,1000000,1,4627,11795,69,70,139,7,63
65485,443,73,74,17644,1000000,1,4843,12801,73,74,147,7,67
65485,443,85,85,20527,1000000,1,5273,15254,85,85,170,5,80
65485,443,105,105,25328,1000000,1,6595,18733,105,105,210,7,98
65485,443,99,98,23372,1000000,1,6521,16851,99,98,197,9,90
65485,443,100,99,24518,1000000,1,6440,18078,100,99,199,8,93
65485,443,79,79,18583,1000000,1,5421,13162,79,79,158,9,70
65485,443,122,121,29914,1000000,1,7283,22631,122,121,243,5,117
65485,443,104,105,25189,1000000,1,6565,18624,104,105,209,7,98
65485,443,91,91,22956,1000000,1,5065,17891,91,91,182,1,90
65485,443,104,104,25286,1000000,1,6124,19162,104,104,208,4,100
65485,443,109,107,25780,1000000,1,7736,18044,109,107,216,14,95
65485,443,109,108,25730,1000000,1,7458,18272,109,108,217,12,97
65485,443,89,89,21908,1000000,1,5072,16836,89,89,178,2,87
65485,443,112,111,26965,1000000,1,7291,19674,112,111,223,9,103
65485,443,97,96,23434,1000000,1,5905,17529,97,96,193,5,92
65485,443,94,94,22617,1000000,1,6219,16398,94,94,188,9,86
65485,443,101,100,24743,1000000,1,6367,18376,101,100,201,7,94
65485,443,132,132,32111,1000000,1,8649,23462,132,132,264,11,122
65485,443,123,123,29310,1000000,1,7809,21501,123,123,246,9,114
65485,443,92,91,22254,1000000,1,5349,16905,92,91,183,3,89
65485,443,122,121,29315,1000000,1,8065,21250,122,121,243,11,112
65485,443,91,91,22389,1000000,1,5295,17094,91,91,182,3,88
65485,443,70,71,16980,1000000,1,4288,12692,70,71,141,4,67
65485,443,89,89,21305,1000000,1,5993,15312,89,89,178,9,80
65485,443,89,88,21657,1000000,1,5219,16438,89,88,177,3,86
65485,443,94,94,23127,1000000,1,5525,17602,94,94,188,3,91
65485,443,99,99,24157,1000000,1,6501,17656,99,99,198,9,90
65485,443,100,101,23748,1000000,1,6706,17042,100,101,201,10,91
65485,443,88,88,21380,1000000,1,5526,15854,88,88,176,6,83
65485,443,103,104,25787,1000000,1,5979,19808,103,104,207,3,101
65485,443,112,113,26684,1000000,1,7553,19131,112,113,225,11,102
65485,443,115,115,26841,1000000,1,8242,18599,115,115,230,16,99
65485,443,116,117,28080,1000000,1,7590,20490,116,117,233,10,108
65485,443,92,92,22748,1000000,1,5433,17315,92,92,184,3,89
65485,443,99,99,23285,1000000,1,6489,16796,99,99,198,9,90
65485,443,108,111,26967,1000000,1,6515,20452,108,111,219,5,106
65485,443,72,72,17604,1000000,1,4015,13589,72,72,144,1,71
65485,443,81,81,19614,1000000,1,4767,14847,81,81,162,3,78
65485,443,118,120,28466,1000000,1,7793,20673,118,120,238,11,109
65485,443,97,96,22735,1000000,1,6810,15925,97,96,193,12,85
65485,443,118,118,28753,1000000,1,7861,20892,118,118,236,10,109
65485,443,89,88,21175,1000000,1,5580,15595,89,88,177,6,82
65485,443,95,94,23736,1000000,1,6182,17554,95,94,189,8,88
65485,443,103,103,24817,1000000,1,7007,17810,103,103,206,11,93
65485,443,80,77,19196,1000000,1,4967,14229,80,77,157,5,75
65485,443,99,98,24047,1000000,1,6156,17891,99,98,197,6,92
65485,443,75,76,18755,1000000,1,4558,14197,75,76,151,4,72
65485,443,24,23,5527,1000000,1,1804,3723,24,23,47,4,20
65485,443,50,49,11599,1000000,1,3589,8010,50,49,99,7,43
65485,443,114,113,26971,1000000,1,7613,19358,114,113,227,11,103
65485,443,104,104,25416,1000000,1,5918,19498,104,104,208,2,102
65485,443,90,92,22201,1000000,1,5368,16833,90,92,182,4,88
65485,443,96,97,22878,1000000,1,6276,16602,96,97,193,8,89
65485,443,123,122,28826,1000000,1,8583,20243,123,122,245,15,108
65485,443,114,112,27593,1000000,1,7323,20270,114,112,226,9,105
65485,443,92,92,22388,1000000,1,5778,16610,92,92,184,6,86
65485,443,117,119,28410,1000000,1,7390,21020,117,119,236,8,111
65485,443,110,110,27012,1000000,1,6611,20401,110,110,220,5,105
65485,443,96,96,23318,1000000,1,5843,17475,96,96,192,5,91
65485,443,101,101,23960,1000000,1,6768,17192,101,101,202,10,92
65485,443,99,101,23349,1000000,1,7251,16098,99,101,200,15,86
65485,443,86,85,20672,1000000,1,5406,15266,86,85,171,6,80
65485,443,98,99,23810,1000000,1,6229,17581,98,99,197,7,92
65485,443,80,81,19203,1000000,1,5368,13835,80,81,161,8,73
65485,443,91,90,22033,1000000,1,5446,16587,91,90,181,4,87
65485,443,63,62,15230,1000000,1,3910,11320,63,62,125,4,59
65485,443,57,57,12834,1000000,1,4475,8359,57,57,114,11,46
65485,443,45,45,10206,1000000,1,3446,6760,45,45,90,8,37
65485,443,44,44,10729,1000000,1,2642,8087,44,44,88,2,42
65485,443,44,43,10483,1000000,1,2920,7563,44,43,87,4,40
65485,443,37,37,8670,1000000,1,2506,6164,37,37,74,4,33
65485,443,31,31,7194,1000000,1,2182,5012,31,31,62,4,27
65485,443,41,41,9222,1000000,1,3230,5992,41,41,82,8,33
65485,443,34,34,7976,1000000,1,2737,5239,34,34,68,7,28
65485,443,33,33,8011,1000000,1,2036,5975,33,33,66,2,31
65485,443,35,34,7045,1000000,1,3795,3250,35,34,69,15,20
65485,443,48,47,10695,1000000,1,3989,6706,48,47,95,11,37
65485,443,51,49,11575,1000000,1,3897,7678,51,49,100,9,42
65485,443,106,106,25715,1000000,1,6530,19185,106,106,212,6,100
65485,443,114,115,27227,1000000,1,7855,19372,114,115,229,13,102
65485,443,124,123,29351,1000000,1,8880,20471,124,123,247,16,108
65485,443,114,113,27899,1000000,1,6930,20969,114,113,227,6,108
65485,443,98,98,23962,1000000,1,5868,18094,98,98,196,4,94
65485,443,95,95,22658,1000000,1,6063,16595,95,95,190,7,88
65485,443,92,92,21780,1000000,1,5996,15784,92,92,184,8,84
65485,443,79,79,19003,1000000,1,4901,14102,79,79,158,5,74
65485,443,89,90,22203,1000000,1,5243,16960,89,90,179,3,87
65485,443,109,109,26203,1000000,1,7664,18539,109,109,218,14,96
65485,443,86,88,20897,1000000,1,5176,15721,86,88,174,4,83
65485,443,90,89,21667,1000000,1,5519,16148,90,89,179,5,85
65485,443,68,68,16104,1000000,1,4446,11658,68,68,136,6,62
65485,443,33,32,7643,1000000,1,2671,4972,33,32,65,7,26
65485,443,29,29,6512,1000000,1,2455,4057,29,29,58,7,22
65485,443,18,18,4449,1000000,1,1099,3350,18,18,36,1,17
65485,443,46,46,10190,1000000,1,3893,6297,46,46,92,11,35
65485,443,42,42,9479,1000000,1,3157,6322,42,42,84,7,35
65485,443,36,37,8432,1000000,1,2738,5694,36,37,73,6,31
65485,443,64,63,15163,1000000,1,4230,10933,64,63,127,6,58
65485,443,98,99,23461,1000000,1,6086,17375,98,99,197,6,92
65485,443,33,32,7621,1000000,1,2417,5204,33,32,65,5,28
65485,443,18,18,4136,1000000,1,1385,2751,18,18,36,3,15
65485,443,27,27,5898,1000000,1,2359,3539,27,27,54,7,20
65485,443,30,30,6516,1000000,1,2636,3880,30,30,60,8,22
65485,443,41,40,8521,1000000,1,4119,4402,41,40,81,15,26
65485,443,32,32,7548,1000000,1,2109,5439,32,32,64,3,29
65485,443,33,33,7254,1000000,1,2798,4456,33,33,66,8,25
65485,443,24,24,5472,1000000,1,1804,3668,24,24,48,4,20
65485,443,36,34,7778,1000000,1,3341,4437,36,34,70,11,25
65485,443,91,91,22323,1000000,1,5212,17111,91,91,182,2,89
65485,443,81,80,19410,1000000,1,4755,14655,81,80,161,3,77
65485,443,96,97,23293,1000000,1,5819,17474,96,97,193,5,92
65485,443,97,96,23241,1000000,1,6405,16836,97,96,193,9,89
65485,443,47,46,11186,1000000,1,3173,8013,47,46,93,5,42
65485,443,67,66,15902,1000000,1,4507,11395,67,66,133,7,60
65485,443,64,64,15519,1000000,1,4091,11428,64,64,128,5,59
65485,443,63,64,14960,1000000,1,4418,10542,63,64,127,8,56
65485,443,60,60,14592,1000000,1,4046,10546,60,60,120,6,54
65485,443,67,67,16485,1000000,1,3999,12486,67,67,134,3,64
65485,443,95,96,22926,1000000,1,5904,17022,95,96,191,6,90
65485,443,126,126,30493,1000000,1,7602,22891,126,126,252,6,120
65485,443,91,90,21902,1000000,1,5327,16575,91,90,181,3,87
65485,443,88,92,21425,1000000,1,5641,15784,88,92,180,7,84
65485,443,89,88,21752,1000000,1,5314,16438,89,88,177,4,86
65485,443,73,73,17011,1000000,1,5085,11926,73,73,146,9,64
65485,443,95,96,22562,1000000,1,6317,16245,95,96,191,9,87
65485,443,103,103,24498,1000000,1,6602,17896,103,103,206,8,95
65485,443,96,96,23263,1000000,1,5633,17630,96,96,192,3,93
65485,443,104,105,25572,1000000,1,6117,19455,104,105,209,3,102
65485,443,79,79,18354,1000000,1,5536,12818,79,79,158,10,69
65485,443,56,57,13212,1000000,1,3913,9299,56,57,113,7,50
65485,443,92,91,22065,1000000,1,6008,16057,92,91,183,8,84
65485,443,58,58,13621,1000000,1,4021,9600,58,58,116,7,51
65485,443,42,42,10552,1000000,1,2522,8030,42,42,84,2,40
65485,443,50,50,11545,1000000,1,3716,7829,50,50,100,8,42
65485,443,70,70,16578,1000000,1,5304,11274,70,70,140,12,58
65485,443,89,90,21136,1000000,1,6203,14933,89,90,179,11,79
65485,443,124,124,30303,1000000,1,7343,22960,124,124,248,5,119
65485,443,110,112,27472,1000000,1,6956,20516,110,112,222,8,104
65485,443,91,91,22499,1000000,1,5422,17077,91,91,182,4,87
65485,443,59,60,13862,1000000,1,4202,9660,59,60,119,8,52
65485,443,38,38,8612,1000000,1,2941,5671,38,38,76,7,31
65485,443,32,32,7777,1000000,1,1994,5783,32,32,64,2,30
65485,443,22,22,5196,1000000,1,1442,3754,22,22,44,2,20
65485,443,38,38,8593,1000000,1,3068,5525,38,38,76,8,30
65485,443,44,44,9744,1000000,1,3646,6098,44,44,88,10,34
65485,443,27,27,6210,1000000,1,1966,4244,27,27,54,4,23
65485,443,46,46,10885,1000000,1,3119,7766,46,46,92,5,41
65485,443,99,100,23256,1000000,1,6616,16640,99,100,199,10,89
65485,443,108,108,25615,1000000,1,7229,18386,108,108,216,11,98
65485,443,109,110,26167,1000000,1,6902,19265,109,110,219,8,102
65485,443,101,101,24091,1000000,1,6470,17621,101,101,202,8,93
65485,443,89,89,21138,1000000,1,5695,15443,89,89,178,7,82
65485,443,88,88,21216,1000000,1,5260,15956,88,88,176,4,84
65485,443,41,41,9126,1000000,1,3369,5757,41,41,82,9,32
65485,443,30,30,7076,1000000,1,2001,5075,30,30,60,3,27
65485,443,34,34,7716,1000000,1,2598,5118,34,34,68,6,28
65485,443,33,33,7578,1000000,1,2417,5161,33,33,66,5,28
65485,443,33,33,7794,1000000,1,2163,5631,33,33,66,3,30
65485,443,36,36,8100,1000000,1,2833,5267,36,36,72,7,29
65485,443,60,60,13896,1000000,1,4256,9640,60,60,120,8,52
65485,443,92,92,22416,1000000,1,5222,17194,92,92,184,2,90
65485,443,95,94,22556,1000000,1,6019,16537,95,94,189,7,87
65485,443,102,104,24396,1000000,1,6778,17618,102,104,206,10,94
65485,443,90,90,21209,1000000,1,6130,15079,90,90,180,10,80
65485,443,60,59,13508,1000000,1,4510,8998,60,59,119,10,49
65485,443,37,39,8838,1000000,1,2760,6078,37,39,76,6,33
65485,443,41,41,9438,1000000,1,2976,6462,41,41,82,6,35
65485,443,37,37,8238,1000000,1,3014,5224,37,37,74,8,29
65485,443,67,68,16154,1000000,1,4253,11901,67,68,135,5,63
65485,443,90,91,21686,1000000,1,5876,15810,90,91,181,8,83
65485,443,107,107,25611,1000000,1,6667,18944,107,107,214,7,100
65485,443,77,77,18510,1000000,1,4666,13844,77,77,154,4,73
65485,443,83,83,20115,1000000,1,4990,15125,83,83,166,4,79
65485,443,103,103,24476,1000000,1,6832,17644,103,103,206,10,93
65485,443,98,97,23052,1000000,1,6308,16744,98,97,195,8,89
65485,443,97,98,23408,1000000,1,6254,17154,97,98,195,8,90
65485,443,99,99,23490,1000000,1,6362,17128,99,99,198,8,91
65485,443,80,80,18969,1000000,1,5209,13760,80,80,160,7,73
65485,443,79,82,19471,1000000,1,5028,14443,79,82,161,6,76
65485,443,89,91,21872,1000000,1,5441,16431,89,91,180,5,86
65485,443,101,101,24441,1000000,1,6216,18225,101,101,202,6,95
65485,443,108,110,26305,1000000,1,6721,19584,108,110,218,7,103
65485,443,101,101,24740,1000000,1,5835,18905,101,101,202,3,98
65485,443,76,76,18068,1000000,1,4866,13202,76,76,152,6,70
65485,443,139,138,33706,1000000,1,9030,24676,139,138,277,12,126
65485,443,125,128,29817,1000000,1,8909,20908,125,128,253,17,111
65485,443,91,92,22038,1000000,1,5549,16489,91,92,183,5,87
65485,443,78,78,18660,1000000,1,4859,13801,78,78,156,5,73
65485,443,73,73,17551,1000000,1,4450,13101,73,73,146,4,69
65485,443,92,92,21553,1000000,1,6365,15188,92,92,184,11,81
65485,443,92,93,22051,1000000,1,5857,16194,92,93,185,7,85
65485,443,92,91,21836,1000000,1,5984,15852,92,91,183,8,84
65485,443,81,82,19590,1000000,1,5009,14581,81,82,163,5,77
65485,443,89,89,21777,1000000,1,5314,16463,89,89,178,4,85
65485,443,99,99,23510,1000000,1,6362,17148,99,99,198,8,91
65485,443,94,94,22369,1000000,1,6092,16277,94,94,188,8,86
65485,443,94,94,22389,1000000,1,6092,16297,94,94,188,8,86
65485,443,90,90,21517,1000000,1,5622,15895,90,90,180,6,84
65485,443,91,92,21409,1000000,1,6311,15098,91,92,183,11,81
65485,443,72,72,17388,1000000,1,4269,13119,72,72,144,3,69
65485,443,69,69,16886,1000000,1,3853,13033,69,69,138,1,68
65485,443,75,75,18018,1000000,1,4558,13460,75,75,150,4,71
65485,443,88,88,20716,1000000,1,6022,14694,88,88,176,10,78
65485,443,87,87,21189,1000000,1,5333,15856,87,87,174,5,82
65485,443,87,87,20539,1000000,1,5841,14698,87,87,174,9,78
65485,443,82,82,19417,1000000,1,5444,13973,82,82,164,8,74
65485,443,84,84,20563,1000000,1,5552,15011,84,84,168,8,76
65485,443,88,88,21325,1000000,1,5260,16065,88,88,176,4,84
65485,443,81,82,19580,1000000,1,5263,14317,81,82,163,7,75
65485,443,83,83,19905,1000000,1,5371,14534,83,83,166,7,76
65485,443,76,76,18588,1000000,1,4231,14357,76,76,152,1,75
65485,443,108,109,26028,1000000,1,7229,18799,108,109,217,11,98
65485,443,92,92,21876,1000000,1,5857,16019,92,92,184,7,85
65485,443,88,88,21258,1000000,1,5514,15744,88,88,176,6,82
65485,443,93,93,21906,1000000,1,6165,15741,93,93,186,9,84
65485,443,91,93,22775,1000000,1,5549,17226,91,93,184,5,88
65485,443,106,107,25300,1000000,1,7375,17925,106,107,213,13,94
65485,443,99,99,23274,1000000,1,6616,16658,99,99,198,10,89
65485,443,44,44,10526,1000000,1,2884,7642,44,44,88,4,40
65485,443,25,25,5610,1000000,1,1985,3625,25,25,50,5,20
65485,443,45,45,10555,1000000,1,3065,7490,45,45,90,5,40
65485,443,84,84,20450,1000000,1,5044,15406,84,84,168,4,80
65485,443,89,89,21376,1000000,1,5695,15681,89,89,178,7,82
65485,443,103,102,25040,1000000,1,5943,19097,103,102,205,3,99
65485,443,103,105,24752,1000000,1,6959,17793,103,105,208,11,94
65485,443,95,95,23268,1000000,1,6019,17249,95,95,190,7,88
65485,443,87,87,21208,1000000,1,5206,16002,87,87,174,4,83
65485,443,101,101,23768,1000000,1,6978,16790,101,101,202,12,89
65485,443,99,100,23790,1000000,1,6235,17555,99,100,199,7,93
65485,443,28,28,6806,1000000,1,1766,5040,28,28,56,2,26
65485,443,23,23,5462,1000000,1,1496,3966,23,23,46,2,21
65485,443,45,45,9882,1000000,1,3827,6055,45,45,90,11,34
65485,443,47,47,10399,1000000,1,3935,6464,47,47,94,11,36
65485,443,33,33,7470,1000000,1,2544,4926,33,33,66,6,27
65485,443,28,28,5947,1000000,1,2528,3419,28,28,56,8,20
65485,443,30,30,6613,1000000,1,2636,3977,30,30,60,8,22
65485,443,29,29,6487,1000000,1,2455,4032,29,29,58,7,22
65485,443,58,58,12472,1000000,1,5291,7181,58,58,116,17,41
65485,443,29,29,6594,1000000,1,2563,4031,31,31,62,7,22
65485,443,32,32,7460,1000000,1,2417,5043,33,33,66,5,27
65485,443,56,56,13236,1000000,1,3659,9577,56,56,112,5,51
65485,443,89,89,21787,1000000,1,5060,16727,89,89,178,2,87
65485,443,95,96,22590,1000000,1,6273,16317,95,96,191,9,87
65485,443,101,103,25372,1000000,1,6470,18902,101,103,204,8,95
65485,443,116,116,27672,1000000,1,7280,20392,116,116,232,8,108
65485,443,109,109,26187,1000000,1,6775,19412,109,109,218,7,102
65485,443,87,87,20430,1000000,1,5841,14589,87,87,174,9,78
65485,443,81,82,20131,1000000,1,4513,15618,81,82,163,1,81
65485,443,92,91,21842,1000000,1,6250,15592,92,91,183,10,83
65485,443,89,89,21246,1000000,1,5568,15678,89,89,178,6,83
65485,443,73,73,17115,1000000,1,5085,12030,73,73,146,9,64
65485,443,38,38,8700,1000000,1,2814,5886,38,38,76,6,32
65485,443,42,42,9684,1000000,1,3030,6654,42,42,84,6,36
65485,443,37,38,8646,1000000,1,2760,5886,37,38,75,6,32
65485,443,38,39,8784,1000000,1,2941,5843,38,39,77,7,32
65485,443,42,44,9877,1000000,1,3284,6593,42,44,86,8,36
65485,443,30,30,6948,1000000,1,2128,4820,30,30,60,4,26
65485,443,31,32,7494,1000000,1,2055,5439,31,32,63,3,29
65485,443,29,29,6918,1000000,1,1820,5098,29,29,58,2,27
65485,443,45,45,10207,1000000,1,3573,6634,45,45,90,9,36
65485,443,40,40,9001,1000000,1,3176,5825,40,40,80,8,32
65485,443,37,37,8454,1000000,1,2760,5694,37,37,74,6,31
65485,443,72,72,17021,1000000,1,4801,12220,72,72,144,7,65
65485,443,95,94,22785,1000000,1,6539,16246,95,94,189,11,83
65485,443,56,57,13564,1000000,1,3913,9651,56,57,113,7,50
65485,443,43,43,10147,1000000,1,2957,7190,43,43,86,5,38
65485,443,68,68,15972,1000000,1,4561,11411,68,68,136,7,61
65485,443,113,114,27398,1000000,1,6908,20490,113,114,227,6,108
65485,443,100,100,24072,1000000,1,6047,18025,100,100,200,5,95
65485,443,74,74,18096,1000000,1,4123,13973,74,74,148,1,73
65485,443,87,87,20971,1000000,1,5333,15638,87,87,174,5,82
65485,443,90,90,21385,1000000,1,5876,15509,90,90,180,8,82
65485,443,44,44,10406,1000000,1,3150,7256,44,44,88,6,38
65485,443,56,55,13428,1000000,1,4040,9388,56,55,111,8,48
65485,443,46,46,10915,1000000,1,3246,7669,46,46,92,6,41
65485,443,50,50,11761,1000000,1,3462,8299,50,50,100,6,44
65485,443,30,30,6948,1000000,1,2128,4820,30,30,60,4,26
65485,443,29,29,6486,1000000,1,2328,4158,29,29,58,6,23
65485,443,26,26,5748,1000000,1,2166,3582,26,26,52,6,20
65485,443,31,31,6915,1000000,1,2563,4352,31,31,62,7,24
65485,443,20,19,4651,1000000,1,1461,3190,20,19,39,3,17
65485,443,19,19,4373,1000000,1,1292,3081,19,19,38,2,17
65485,443,36,37,7968,1000000,1,3214,4754,36,37,73,10,27
65485,443,31,31,6782,1000000,1,2690,4092,31,31,62,8,23
65485,443,20,20,4596,1000000,1,1461,3135,20,20,40,3,17
65485,443,21,21,4842,1000000,1,1515,3327,21,21,42,3,18
65485,443,29,29,6511,1000000,1,2328,4183,29,29,58,6,23
65485,443,17,18,4266,1000000,1,1045,3221,17,18,35,1,17
65485,443,35,35,7962,1000000,1,2652,5310,35,35,70,6,29
65485,443,39,39,8946,1000000,1,2868,6078,39,39,78,6,33
65485,443,55,54,12938,1000000,1,3859,9079,55,54,109,7,48
65485,443,57,58,13185,1000000,1,4626,8559,57,58,115,12,46
65485,443,67,67,15732,1000000,1,5269,10463,67,67,134,13,54
65485,443,94,94,22730,1000000,1,5723,17007,94,94,188,5,89
65485,443,115,115,28137,1000000,1,7111,21026,115,115,230,7,110
65485,443,96,96,22784,1000000,1,6212,16572,96,96,192,8,88
65485,443,95,95,22746,1000000,1,5916,16830,95,95,190,6,89
65485,443,115,115,27746,1000000,1,7076,20670,115,115,230,6,109
65485,443,83,83,19338,1000000,1,5752,13586,83,83,166,10,73
65485,443,28,28,6284,1000000,1,2318,3966,28,28,56,6,22
65485,443,34,34,7284,1000000,1,3106,4178,34,34,68,10,24
65485,443,39,40,8834,1000000,1,3249,5585,39,40,79,9,31
65485,443,37,37,8238,1000000,1,3014,5224,37,37,74,8,29
65485,443,30,30,7057,1000000,1,2128,4929,30,30,60,4,26
65485,443,25,25,5718,1000000,1,1858,3860,25,25,50,4,21
65485,443,29,29,6398,1000000,1,2455,3943,29,29,58,7,22
65485,443,33,32,7550,1000000,1,2695,4855,33,32,65,7,26
65485,443,42,42,9036,1000000,1,3792,5244,42,42,84,12,30
65485,443,35,35,8396,1000000,1,2398,5998,35,35,70,4,31
65485,443,31,31,7194,1000000,1,2182,5012,31,31,62,4,27
65485,443,105,105,25427,1000000,1,6837,18590,105,105,210,9,96
65485,443,96,97,23338,1000000,1,6141,17197,96,97,193,7,90
65485,443,107,109,25838,1000000,1,7005,18833,107,109,216,9,100
65485,443,98,96,23431,1000000,1,6356,17075,98,96,194,8,90
65485,443,102,102,24896,1000000,1,6211,18685,102,102,204,5,97
65485,443,114,114,27430,1000000,1,7633,19797,114,114,228,11,105
65485,443,86,86,20641,1000000,1,5430,15211,86,86,172,6,80
65485,443,96,95,23372,1000000,1,5716,17656,96,95,191,4,92
65485,443,79,79,18926,1000000,1,4933,13993,79,79,158,5,74
65485,443,82,82,19911,1000000,1,5095,14816,82,82,164,5,78
65485,443,89,90,22317,1000000,1,4945,17372,89,90,179,1,89
65485,443,78,79,18918,1000000,1,5022,13896,78,79,157,6,73
65485,443,83,83,20248,1000000,1,5034,15214,83,83,166,4,79
65485,443,100,101,24294,1000000,1,6738,17556,100,101,201,10,91
65485,443,87,89,20522,1000000,1,6627,13895,87,89,176,15,74
65485,443,105,105,25468,1000000,1,6500,18968,105,105,210,6,99
65485,443,93,93,22381,1000000,1,5923,16458,93,93,186,7,87
65485,443,100,99,23967,1000000,1,6357,17610,100,99,199,7,93
65485,443,28,28,6792,1000000,1,1639,5153,28,28,56,1,27
65485,443,72,72,17451,1000000,1,4547,12904,72,72,144,5,68
65485,443,120,120,29532,1000000,1,7695,21837,120,120,240,9,111
65485,443,115,115,27639,1000000,1,7679,19960,115,115,230,11,105
65485,443,87,87,21469,1000000,1,4988,16481,87,87,174,2,85
65485,443,87,87,21090,1000000,1,5091,15999,87,87,174,3,84
65485,443,81,80,19441,1000000,1,5009,14432,81,80,161,5,76
65485,443,118,118,28692,1000000,1,6976,21716,118,118,236,4,114
65485,443,111,110,26417,1000000,1,7400,19017,111,110,221,10,101
65485,443,92,92,22384,1000000,1,6123,16261,92,92,184,9,84
65485,443,135,134,33156,1000000,1,8378,24778,135,134,269,8,128
65485,443,114,114,28267,1000000,1,7019,21248,114,114,228,5,110
65485,443,88,86,21180,1000000,1,6288,14892,88,86,174,12,76
65485,443,93,94,22704,1000000,1,5693,17011,93,94,187,5,90
65485,443,125,127,30881,1000000,1,7660,23221,125,127,252,6,121
65485,443,113,111,26559,1000000,1,7682,18877,113,111,224,12,101
65485,443,94,95,22897,1000000,1,5723,17174,94,95,189,5,90
65485,443,84,85,20580,1000000,1,4965,15615,84,85,169,3,82
65485,443,88,87,21500,1000000,1,5145,16355,88,87,175,3,85
65485,443,119,120,28335,1000000,1,8439,19896,119,120,239,15,105
65485,443,103,102,25065,1000000,1,6603,18462,103,102,205,7,97
65485,443,104,102,24257,1000000,1,8041,16216,104,102,206,19,87
65485,443,109,109,26219,1000000,1,7062,19157,109,109,218,8,101
65485,443,89,89,21876,1000000,1,5120,16756,89,89,178,2,87
65485,443,98,100,23936,1000000,1,6146,17790,98,100,198,6,94
65485,443,96,95,23332,1000000,1,6097,17235,96,95,191,7,91
65485,443,90,89,21897,1000000,1,5519,16378,90,89,179,5,85
65485,443,103,101,24878,1000000,1,6646,18232,103,101,204,8,95
65485,443,87,87,21536,1000000,1,4849,16687,87,87,174,1,86
65485,443,93,92,22490,1000000,1,5725,16765,93,92,185,5,88
65485,443,99,99,23682,1000000,1,6319,17363,99,99,198,7,92
65485,443,102,101,25214,1000000,1,6501,18713,102,101,203,7,95
65485,443,116,117,28105,1000000,1,7606,20499,116,117,233,10,107
65485,443,116,116,27944,1000000,1,7666,20278,116,116,232,10,107
65485,443,88,87,20822,1000000,1,5995,14827,88,87,175,9,78
65485,443,131,134,32939,1000000,1,8250,24689,131,134,265,8,126
65485,443,98,98,23527,1000000,1,5983,17544,98,98,196,5,93
65485,443,123,122,29313,1000000,1,7972,21341,123,122,245,10,113
65485,443,62,61,14467,1000000,1,4388,10079,62,61,123,8,54
65485,443,31,31,7009,1000000,1,2690,4319,31,31,62,8,24
65485,443,29,27,6573,1000000,1,2499,4074,29,27,56,7,22
65485,443,31,31,6859,1000000,1,2690,4169,31,31,62,8,23
65485,443,34,34,7512,1000000,1,2864,4648,34,34,68,8,26
65485,443,35,35,8471,1000000,1,2696,5775,35,35,70,6,30
65485,443,15,15,3582,1000000,1,937,2645,15,15,30,1,14
65485,443,28,28,6348,1000000,1,2147,4201,28,28,56,5,23
65485,443,37,35,7995,1000000,1,3395,4600,37,35,72,11,25
65485,443,30,31,6752,1000000,1,2680,4072,30,31,61,8,23
65485,443,44,41,9724,1000000,1,3817,5907,44,41,85,11,33
65485,443,36,34,8006,1000000,1,3099,4907,36,34,70,9,27
65485,443,30,30,6840,1000000,1,2255,4585,30,30,60,5,25
65485,443,39,37,8744,1000000,1,3261,5483,39,37,76,9,30
65485,443,39,37,8733,1000000,1,3376,5357,39,37,76,10,29
65485,443,45,44,10101,1000000,1,3736,6365,45,44,89,10,35
65485,443,44,42,9758,1000000,1,3646,6112,44,42,86,10,34
65485,443,49,44,11033,1000000,1,4182,6851,49,44,93,12,37
65485,443,37,37,8574,1000000,1,2645,5929,37,37,74,5,32
65485,443,32,30,7323,1000000,1,2248,5075,32,30,62,4,27
65485,443,46,45,10431,1000000,1,4008,6423,46,45,91,12,35
65485,443,40,38,8870,1000000,1,3430,5440,40,38,78,10,30
65485,443,31,29,7208,1000000,1,2321,4887,31,29,60,5,26
65485,443,33,33,7968,1000000,1,2199,5769,33,33,66,3,30
65485,443,53,50,11721,1000000,1,4779,6942,53,50,103,15,39
65485,443,38,38,8838,1000000,1,2814,6024,38,38,76,6,32
65485,443,44,39,9714,1000000,1,3932,5782,44,39,83,12,32
65485,443,35,34,8029,1000000,1,2664,5365,35,34,69,6,29
65485,443,87,86,20956,1000000,1,5461,15495,87,86,173,5,81
65485,443,111,112,27673,1000000,1,6821,20852,111,112,223,5,107
65485,443,101,101,24825,1000000,1,6669,18156,101,101,202,9,94
65485,443,123,120,29609,1000000,1,8306,21303,123,120,243,11,112
65485,443,111,108,26691,1000000,1,6955,19736,111,108,219,7,104
65485,443,99,96,24099,1000000,1,6295,17804,99,96,195,7,92
65485,443,85,85,21611,1000000,1,4940,16671,85,85,170,2,83
65485,443,76,76,18745,1000000,1,4902,13843,76,76,152,6,71
65485,443,87,87,21177,1000000,1,6028,15149,87,87,174,10,78
65485,443,101,99,23911,1000000,1,7074,16837,101,99,200,12,88
65485,443,86,87,20732,1000000,1,5418,15314,86,87,173,6,81
65485,443,105,106,25782,1000000,1,6544,19238,105,106,211,6,100
65485,443,104,101,24886,1000000,1,6994,17892,104,101,205,10,94
65485,443,97,96,23401,1000000,1,5897,17504,97,96,193,5,92
65485,443,104,103,24761,1000000,1,6930,17831,104,103,207,10,95
65485,443,98,98,24373,1000000,1,6146,18227,98,98,196,6,93
65485,443,85,84,20746,1000000,1,5202,15544,85,84,169,4,81
65485,443,85,85,20403,1000000,1,5733,14670,85,85,170,9,77
65485,443,96,96,23114,1000000,1,6189,16925,96,96,192,7,89
65485,443,106,106,26428,1000000,1,6372,20056,106,106,212,4,102
65485,443,111,111,27812,1000000,1,6253,21559,111,111,222,1,110
65485,443,78,78,19336,1000000,1,4709,14627,78,78,156,3,75
65485,443,54,49,12075,1000000,1,4579,7496,54,49,103,13,41
65485,443,101,100,24038,1000000,1,7026,17012,101,100,201,12,89
65485,443,86,86,20665,1000000,1,5454,15211,86,86,172,6,80
65485,443,84,84,21053,1000000,1,4850,16203,84,84,168,2,82
65485,443,96,96,23749,1000000,1,5637,18112,96,96,192,3,93
65485,443,85,85,20816,1000000,1,5400,15416,85,85,170,6,80
65485,443,79,78,19005,1000000,1,5306,13699,79,78,157,8,72
65485,443,35,33,8072,1000000,1,2652,5420,35,33,68,6,29
65485,443,47,47,11346,1000000,1,2792,8554,47,47,94,2,45
65485,443,115,113,28022,1000000,1,7533,20489,115,113,228,9,106
65485,443,108,108,26520,1000000,1,6671,19849,108,108,216,5,103
65485,443,36,37,8653,1000000,1,2615,6038,36,37,73,5,32
65485,443,53,48,12365,1000000,1,5053,7312,53,48,101,17,36
65485,443,76,75,17980,1000000,1,5319,12661,76,75,151,9,67
65485,443,117,118,29223,1000000,1,7280,21943,117,118,235,6,112
65485,443,48,48,11897,1000000,1,3168,8729,48,48,96,4,44
65485,443,37,38,9092,1000000,1,2518,6574,37,38,75,4,34
65485,443,41,41,9714,1000000,1,2782,6932,41,41,82,4,37
65485,443,43,42,10340,1000000,1,2957,7383,43,42,85,5,38
65485,443,48,47,11241,1000000,1,3632,7609,48,47,95,8,40
65485,443,60,59,14058,1000000,1,4741,9317,60,59,119,11,49
65485,443,76,75,17635,1000000,1,5573,12062,76,75,151,11,65
65485,443,102,99,24942,1000000,1,6723,18219,102,99,201,9,93
65485,443,92,92,22269,1000000,1,6147,16122,92,92,184,9,85
65485,443,67,67,16268,1000000,1,4206,12062,67,67,134,4,63
65485,443,38,37,8874,1000000,1,2572,6302,38,37,75,4,34
65485,443,109,106,27075,1000000,1,6781,20294,109,106,215,5,104
65485,443,90,91,22846,1000000,1,6155,16691,90,91,181,9,84
65485,443,57,55,13576,1000000,1,4281,9295,57,55,112,9,48
65485,443,55,54,13414,1000000,1,4320,9094,55,54,109,10,47
65485,443,58,58,13562,1000000,1,4323,9239,58,58,116,9,49
65485,443,99,98,24464,1000000,1,6423,18041,99,98,197,7,92
65485,443,109,108,27592,1000000,1,7070,20522,109,108,217,8,102
65485,443,104,99,24498,1000000,1,7419,17079,104,99,203,13,91
65485,443,97,95,23835,1000000,1,6223,17612,97,95,192,7,90
65485,443,51,50,12051,1000000,1,3711,8340,51,50,101,7,44
65485,443,32,29,7302,1000000,1,2937,4365,33,30,63,9,23
65485,443,28,27,6357,1000000,1,2413,3944,28,27,55,7,22
65485,443,36,32,7767,1000000,1,3341,4426,36,32,68,11,25
65485,443,30,28,6538,1000000,1,2763,3775,30,28,58,9,21
65485,443,37,37,7921,1000000,1,3439,4482,37,37,74,11,26
65485,443,27,24,5942,1000000,1,2359,3583,27,24,51,7,20
65485,443,32,30,7888,1000000,1,2133,5755,32,30,62,3,29
65485,443,57,57,13843,1000000,1,3495,10348,57,57,114,3,54
65485,443,60,57,13668,1000000,1,5030,8638,60,57,117,14,46
65485,443,65,63,14377,1000000,1,5737,8640,65,63,128,17,48
65485,443,42,41,9543,1000000,1,3284,6259,42,41,83,8,34
65485,443,47,47,11546,1000000,1,2951,8595,47,47,94,3,44
65485,443,55,53,13275,1000000,1,3768,9507,55,53,108,6,49
65485,443,57,56,12831,1000000,1,4753,8078,57,56,113,13,44
65485,443,35,34,8367,1000000,1,2549,5818,35,34,69,5,30
65485,443,36,35,8275,1000000,1,2718,5557,36,35,71,6,30
65485,443,34,33,8295,1000000,1,2356,5939,34,33,67,4,30
65485,443,41,41,9925,1000000,1,2746,7179,41,41,82,4,38
65485,443,40,40,9720,1000000,1,2704,7016,40,40,80,4,36
65485,443,51,50,12558,1000000,1,3850,8708,51,50,101,8,44
65485,443,55,53,12231,1000000,1,4677,7554,55,53,108,13,42
65485,443,44,43,10066,1000000,1,3646,6420,44,43,87,10,35
65485,443,52,50,11908,1000000,1,4241,7667,52,50,102,11,41
65485,443,45,44,10402,1000000,1,3458,6944,45,44,89,8,37
65485,443,56,52,13177,1000000,1,4283,8894,56,52,108,9,47
65485,443,40,40,9398,1000000,1,2970,6428,40,40,80,6,34
65485,443,58,56,13457,1000000,1,4704,8753,58,56,114,12,46
65485,443,62,56,14439,1000000,1,4988,9451,62,56,118,12,50
65485,443,35,35,8082,1000000,1,2537,5545,35,35,70,5,30
65485,443,36,35,8396,1000000,1,2730,5666,36,35,71,6,30
65485,443,47,46,11273,1000000,1,3094,8179,47,46,93,4,43
65485,443,36,35,8987,1000000,1,2603,6384,36,35,71,5,31
65485,443,47,45,10915,1000000,1,3300,7615,47,45,92,6,41
65485,443,67,64,14964,1000000,1,5801,9163,67,64,131,17,50
65485,443,38,36,9069,1000000,1,2826,6243,38,36,74,6,32
65485,443,30,30,7164,1000000,1,1874,5290,30,30,60,2,28
65485,443,69,65,15754,1000000,1,5965,9789,69,65,134,17,52
65485,443,43,42,9788,1000000,1,3211,6577,43,42,85,7,36
65485,443,36,35,8199,1000000,1,2857,5342,36,35,71,7,29
65485,443,55,52,13019,1000000,1,4300,8719,55,52,107,10,45
65485,443,39,35,8842,1000000,1,3261,5581,39,35,74,9,30
65485,443,28,27,6895,1000000,1,1893,5002,28,27,55,3,25
65485,443,67,59,14938,1000000,1,6861,8077,67,59,126,23,44
65485,443,46,44,11188,1000000,1,3592,7596,46,44,90,8,38
65485,443,31,28,7142,1000000,1,2321,4821,31,28,59,5,26
65485,443,43,43,10448,1000000,1,2759,7689,43,43,86,3,40
65485,443,29,29,6810,1000000,1,1947,4863,29,29,58,3,26
65485,443,53,51,12057,1000000,1,4462,7595,53,51,104,12,41
65485,443,60,53,13451,1000000,1,5078,8373,60,53,113,14,46
65485,443,61,58,14152,1000000,1,5152,9000,61,58,119,13,48
65485,443,48,46,10987,1000000,1,3759,7228,48,46,94,9,39
65485,443,49,47,11452,1000000,1,3928,7524,49,47,96,10,40
65485,443,46,45,10897,1000000,1,3282,7615,46,45,91,6,40
65485,443,44,42,10312,1000000,1,3416,6896,44,42,86,8,36
65485,443,34,34,8253,1000000,1,2495,5758,34,34,68,5,29
65485,443,39,37,9089,1000000,1,3293,5796,39,37,76,9,31
65485,443,56,52,12471,1000000,1,4675,7796,56,52,108,13,43
65485,443,44,44,10175,1000000,1,3555,6620,44,44,88,9,35
65485,443,59,57,13468,1000000,1,4595,8873,59,57,116,11,48
65485,443,48,48,11450,1000000,1,3251,8199,48,48,96,5,43
65485,443,45,44,10707,1000000,1,3379,7328,45,44,89,7,38
65485,443,48,46,11285,1000000,1,3632,7653,48,46,94,8,41
65485,443,55,50,12231,1000000,1,4494,7737,55,50,105,12,43
65485,443,40,37,9077,1000000,1,3327,5750,40,37,77,9,31
65485,443,51,46,11686,1000000,1,3818,7868,51,46,97,8,43
65485,443,48,46,11745,1000000,1,3783,7962,48,46,94,9,39
65485,443,44,44,10440,1000000,1,2932,7508,44,44,88,4,40
65485,443,39,39,9717,1000000,1,2650,7067,39,39,78,4,36
65485,443,49,48,11738,1000000,1,3341,8397,49,48,97,5,43
65485,443,51,50,12111,1000000,1,3548,8563,51,50,101,6,46
65485,443,46,43,10197,1000000,1,4032,6165,46,43,89,12,34
65485,443,80,76,19167,1000000,1,6131,13036,80,76,156,13,67
65485,443,86,82,21277,1000000,1,5982,15295,86,82,168,9,77
65485,443,52,49,12002,1000000,1,3745,8257,52,49,101,7,44
65485,443,38,38,9154,1000000,1,2648,6506,38,38,76,4,35
65485,443,74,72,16758,1000000,1,6386,10372,74,72,146,18,57
65485,443,60,60,14926,1000000,1,3832,11094,60,60,120,4,56
65485,443,96,95,23991,1000000,1,6804,17187,96,95,191,12,84
65485,443,129,127,31814,1000000,1,9856,21958,129,127,256,22,108
65485,443,97,94,23427,1000000,1,6060,17367,97,94,191,6,91
65485,443,95,92,23960,1000000,1,6020,17940,95,92,187,6,89
65485,443,96,94,23228,1000000,1,6590,16638,96,94,190,10,86
65485,443,59,57,13785,1000000,1,4365,9420,59,57,116,9,50
65485,443,31,30,7249,1000000,1,2182,5067,31,30,61,4,27
65485,443,25,25,5934,1000000,1,1604,4330,25,25,50,2,23
65485,443,52,49,11473,1000000,1,4471,7002,52,49,101,13,40
65485,443,89,88,21349,1000000,1,6386,14963,89,88,177,12,78
65485,443,114,115,28387,1000000,1,7463,20924,114,115,229,9,107
65485,443,95,94,23097,1000000,1,6226,16871,95,94,189,8,87
65485,443,113,113,27833,1000000,1,7096,20737,113,113,226,6,107
65485,443,99,94,24741,1000000,1,6911,17830,99,94,193,11,88
65485,443,91,90,22092,1000000,1,6438,15654,91,90,181,11,81
65485,443,97,98,23602,1000000,1,6314,17288,97,98,195,8,90
65485,443,97,97,24530,1000000,1,5664,18866,97,97,194,2,95
65485,443,27,25,6429,1000000,1,1966,4463,27,25,52,4,23
65485,443,29,29,7038,1000000,1,1705,5333,29,29,58,1,28
65485,443,47,46,10749,1000000,1,3979,6770,47,46,93,11,36
65485,443,54,49,11938,1000000,1,4718,7220,54,49,103,14,40
65485,443,34,33,8108,1000000,1,2007,6101,34,33,67,1,32
65485,443,44,43,10448,1000000,1,3440,7008,44,43,87,8,37
65485,443,34,34,8205,1000000,1,2273,5932,34,34,68,3,31
65485,443,86,81,19978,1000000,1,6355,13623,86,81,167,13,73
65485,443,103,102,25099,1000000,1,6293,18806,103,102,205,5,98
65485,443,94,91,23244,1000000,1,6914,16330,94,91,185,14,82
65485,443,58,57,12969,1000000,1,4934,8035,58,57,115,14,44
65485,443,29,26,6553,1000000,1,2213,4340,29,26,55,5,24
65485,443,32,29,6771,1000000,1,3379,3392,32,29,61,13,19
65485,443,23,22,5173,1000000,1,1877,3296,23,22,45,5,18
65485,443,21,20,4897,1000000,1,1515,3382,21,20,41,3,18
65485,443,27,22,5799,1000000,1,2474,3325,27,22,49,8,19
65485,443,43,40,9070,1000000,1,4271,4799,43,40,83,15,28
65485,443,47,45,10845,1000000,1,3717,7128,47,45,92,9,38
65485,443,57,53,13175,1000000,1,4499,8676,57,53,110,11,46
65485,443,56,56,13622,1000000,1,3798,9824,56,56,112,6,52
65485,443,96,96,23416,1000000,1,5958,17458,96,96,192,6,90
65485,443,123,121,30371,1000000,1,7961,22410,123,121,244,9,114
65485,443,94,93,23189,1000000,1,5934,17255,94,93,187,6,88
65485,443,103,102,24938,1000000,1,7031,17907,103,102,205,11,93
65485,443,96,95,22894,1000000,1,6510,16384,96,95,191,10,86
65485,443,96,95,24112,1000000,1,5819,18293,96,95,191,5,91
65485,443,121,119,30112,1000000,1,8119,21993,121,119,240,11,111
65485,443,116,119,29450,1000000,1,7225,22225,116,119,235,7,112
65485,443,94,92,21712,1000000,1,7108,14604,94,92,186,16,78
65485,443,51,48,11103,1000000,1,4671,6432,51,48,99,15,36
65485,443,25,25,6212,1000000,1,1509,4703,25,25,50,1,24
65485,443,63,60,15885,1000000,1,4859,11026,63,60,123,11,54
65485,443,52,48,11855,1000000,1,4471,7384,52,48,100,13,40
65485,443,41,39,9514,1000000,1,3266,6248,41,39,80,8,33
65485,443,34,34,8204,1000000,1,2146,6058,34,34,68,2,32
65485,443,59,58,14557,1000000,1,3603,10954,59,58,117,3,56
65485,443,100,97,24134,1000000,1,6036,18098,100,97,197,4,95
65485,443,100,99,24690,1000000,1,6826,17864,100,99,199,10,91
65485,443,90,89,21780,1000000,1,6095,15685,90,89,179,9,81
65485,443,96,94,22478,1000000,1,6756,15722,96,94,190,12,84
65485,443,78,77,19281,1000000,1,4502,14779,78,77,155,2,76
65485,443,93,93,23335,1000000,1,5094,18241,93,93,186,0,93
65485,443,96,95,23013,1000000,1,6705,16308,96,95,191,11,86
65485,443,108,107,26948,1000000,1,6591,20357,108,107,215,5,103
65485,443,97,95,23391,1000000,1,6290,17101,97,95,192,8,89
65485,443,86,85,22095,1000000,1,5490,16605,86,85,171,6,81
65485,443,100,102,24325,1000000,1,6706,17619,100,102,202,10,93
65485,443,117,115,27892,1000000,1,8109,19783,117,115,232,13,104
65485,443,108,107,26464,1000000,1,7150,19314,108,107,215,10,99
65485,443,105,104,25804,1000000,1,6643,19161,105,104,209,7,98
65485,443,105,105,25291,1000000,1,7425,17866,105,105,210,13,94
65485,443,95,96,23360,1000000,1,5718,17642,95,96,191,4,92
65485,443,111,110,27325,1000000,1,7475,19850,111,110,221,11,100
65485,443,104,104,25806,1000000,1,6633,19173,104,104,208,7,98
65485,443,100,98,25635,1000000,1,6167,19468,100,98,198,5,95
65485,443,80,80,19584,1000000,1,4459,15125,80,80,160,1,79
65485,443,100,99,24661,1000000,1,6048,18613,100,99,199,4,95
65485,443,115,113,27646,1000000,1,8644,19002,115,113,228,18,100
65485,443,49,48,11593,1000000,1,3305,8288,49,48,97,5,44
65485,443,58,57,13396,1000000,1,4446,8950,58,57,115,10,48
65485,443,80,79,19358,1000000,1,5106,14252,80,79,159,6,75
65485,443,103,101,25213,1000000,1,6003,19210,103,101,204,3,100
65485,443,134,132,32733,1000000,1,8797,23936,134,132,266,11,124
65485,443,125,123,30814,1000000,1,8204,22610,125,123,248,10,116
65485,443,88,87,21613,1000000,1,4800,16813,88,87,175,0,87
65485,443,113,111,27612,1000000,1,7647,19965,113,111,224,10,103
65485,443,100,100,24794,1000000,1,6532,18262,100,100,200,8,94
65485,443,105,106,25956,1000000,1,6675,19281,105,106,211,7,99
65485,443,94,94,22889,1000000,1,6001,16888,94,94,188,7,88
65485,443,96,96,22992,1000000,1,6399,16593,96,96,192,9,88
65485,443,82,82,20187,1000000,1,4821,15366,82,82,164,3,79
65485,443,97,97,24263,1000000,1,5779,18484,97,97,194,3,94
65485,443,133,129,32342,1000000,1,9203,23139,133,129,262,15,118
65485,443,102,100,24389,1000000,1,7311,17078,102,100,202,13,89
65485,443,98,96,24426,1000000,1,5975,18451,98,96,194,5,94
65485,443,103,105,25655,1000000,1,6420,19235,103,105,208,6,99
65485,443,113,113,27944,1000000,1,6694,21250,113,113,226,4,110
65485,443,117,113,27608,1000000,1,7954,19654,117,113,230,12,105
65485,443,117,115,29841,1000000,1,7728,22113,117,115,232,10,108
65485,443,96,98,23704,1000000,1,5796,17908,96,98,194,4,93
65485,443,99,98,23886,1000000,1,6962,16924,99,98,197,12,88
65485,443,62,62,14908,1000000,1,4273,10635,62,62,124,7,56
65485,443,84,83,20180,1000000,1,5366,14814,84,83,167,6,78
65485,443,85,85,21614,1000000,1,5365,16249,85,85,170,5,80
65485,443,81,81,19047,1000000,1,5736,13311,81,81,162,10,71
65485,443,97,97,23382,1000000,1,5933,17449,97,97,194,5,92
65485,443,99,98,24269,1000000,1,6180,18089,99,98,197,6,93
65485,443,94,92,22902,1000000,1,6382,16520,94,92,186,10,85
65485,443,99,98,23905,1000000,1,6017,17888,99,98,197,5,94
65485,443,100,101,24524,1000000,1,6266,18258,100,101,201,6,95
65485,443,104,104,25879,1000000,1,6093,19786,104,104,208,3,102
65485,443,102,103,25769,1000000,1,6366,19403,102,103,205,6,97
65485,443,96,93,23141,1000000,1,6705,16436,96,93,189,11,85
65485,443,71,69,16747,1000000,1,5243,11504,71,69,140,11,60
65485,443,86,87,21045,1000000,1,5240,15805,86,87,173,4,83
65485,443,80,79,19447,1000000,1,4737,14710,80,79,159,3,77
65485,443,100,96,23975,1000000,1,7087,16888,100,96,196,13,87
65485,443,85,85,20737,1000000,1,5110,15627,85,85,170,4,81
65485,443,89,89,22767,1000000,1,5362,17405,89,89,178,4,85
65485,443,78,79,19011,1000000,1,5006,14005,78,79,157,6,74
65485,443,37,34,7958,1000000,1,3395,4563,37,34,71,11,26
65485,443,33,31,7039,1000000,1,3064,3975,33,31,64,10,23
65485,443,26,26,5900,1000000,1,2083,3817,26,26,52,5,21
65485,443,39,37,8516,1000000,1,3503,5013,39,37,76,11,28
65485,443,39,37,8745,1000000,1,3400,5345,39,37,76,10,29
65485,443,18,18,4384,1000000,1,1163,3221,18,18,36,1,17
65485,443,40,39,8848,1000000,1,3589,5259,40,39,79,11,29
65485,443,45,43,10144,1000000,1,3744,6400,45,43,88,10,35
65485,443,31,30,6924,1000000,1,2436,4488,31,30,61,6,25
65485,443,26,25,5944,1000000,1,2198,3746,26,25,51,6,20
65485,443,42,40,9201,1000000,1,3550,5651,42,40,82,10,32
65485,443,29,29,6854,1000000,1,1991,4863,29,29,58,3,26
65485,443,38,35,8444,1000000,1,3219,5225,38,35,73,9,29
65485,443,43,42,9587,1000000,1,3858,5729,43,42,85,12,31
65485,443,29,27,6527,1000000,1,2709,3818,29,27,56,8,21
65485,443,21,21,5070,1000000,1,1273,3797,21,21,42,1,20
65485,443,32,33,7774,1000000,1,2375,5399,32,33,65,5,28
65485,443,23,24,5215,1000000,1,1963,3252,24,25,49,5,18
65485,443,55,52,11145,1000000,1,6157,4988,55,52,107,25,31
65485,443,51,49,10699,1000000,1,4913,5786,51,49,100,17,34
65485,443,18,18,4212,1000000,1,1226,2986,18,18,36,2,16
65485,443,28,28,6240,1000000,1,2274,3966,28,28,56,6,22
65485,443,40,37,8601,1000000,1,3811,4790,40,37,77,13,27
65485,443,32,30,6871,1000000,1,2744,4127,32,30,62,8,23
65485,443,26,28,6044,1000000,1,2293,3751,26,28,54,7,21
65485,443,32,32,7020,1000000,1,2756,4264,32,32,64,8,24
65485,443,20,20,4596,1000000,1,1461,3135,20,20,40,3,17
65485,443,25,23,5491,1000000,1,2112,3379,25,23,48,6,19
65485,443,21,21,4842,1000000,1,1515,3327,21,21,42,3,18
65485,443,40,39,9183,1000000,1,3073,6110,40,39,79,7,33
65485,443,23,23,5010,1000000,1,2185,2825,24,24,48,7,16
65485,443,23,21,5157,1000000,1,2378,2779,25,23,48,8,15
65485,443,15,15,3475,1000000,1,1372,2103,16,16,32,4,11
65485,443,27,27,5346,1000000,1,2982,2364,27,27,54,12,15
65485,443,24,24,5256,1000000,1,2239,3017,25,25,50,7,17
65485,443,17,17,3896,1000000,1,1607,2289,18,18,36,5,12
65485,443,17,15,3752,1000000,1,1746,2006,18,16,34,6,11
65485,443,17,17,3966,1000000,1,1534,2432,19,19,38,4,13
65485,443,19,19,4596,1000000,1,1461,3135,20,20,40,3,16
65485,443,16,16,3421,1000000,1,1499,1922,16,16,32,5,11
65485,443,101,101,24202,1000000,1,6435,17767,101,101,202,7,94
65485,443,117,116,27255,1000000,1,8422,18833,117,116,233,16,102
65485,443,99,99,23859,1000000,1,6152,17707,99,99,198,6,93
65485,443,127,128,30905,1000000,1,8117,22788,127,128,255,9,119
65485,443,137,135,32918,1000000,1,9233,23685,137,135,272,13,124
65485,443,118,118,28774,1000000,1,7504,21270,118,118,236,8,111
65485,443,93,93,22730,1000000,1,5344,17386,93,93,186,2,91
65485,443,103,103,24812,1000000,1,6741,18071,103,103,206,9,95
65485,443,114,112,27727,1000000,1,7606,20121,114,112,226,10,105
65485,443,87,88,21237,1000000,1,5619,15618,87,88,175,7,81
65485,443,135,131,31308,1000000,1,10423,20885,135,131,266,23,113
65485,443,92,93,22436,1000000,1,6298,16138,92,93,185,10,83
65485,443,93,93,22544,1000000,1,5725,16819,93,93,186,5,88
65485,443,90,89,22517,1000000,1,5313,17204,90,89,179,3,87
65485,443,90,89,21975,1000000,1,5543,16432,90,89,179,5,85
65485,443,108,108,26952,1000000,1,6547,20405,108,108,216,5,103
65485,443,129,129,31024,1000000,1,8598,22426,129,129,258,12,118
65485,443,115,116,27764,1000000,1,7624,20140,115,116,231,10,106
65485,443,85,85,20992,1000000,1,4924,16068,85,85,170,2,83
65485,443,97,98,23667,1000000,1,5917,17750,97,98,195,5,93
65485,443,108,108,26106,1000000,1,7202,18904,108,108,216,10,99
65485,443,72,73,17365,1000000,1,4662,12703,72,73,145,6,67
65485,443,34,34,8071,1000000,1,2471,5600,34,34,68,5,30
65485,443,32,31,7495,1000000,1,2236,5259,32,31,63,4,28
65485,443,62,62,14857,1000000,1,4019,10838,62,62,124,5,57
65485,443,106,107,26244,1000000,1,6439,19805,106,107,213,5,102
65485,443,101,101,24501,1000000,1,5911,18590,101,101,202,3,98
65485,443,95,95,22844,1000000,1,6460,16384,95,95,190,10,85
65485,443,77,78,18595,1000000,1,4920,13675,77,78,155,6,72
65485,443,94,93,22558,1000000,1,6243,16315,94,93,187,9,85
65485,443,98,94,23483,1000000,1,6574,16909,98,94,192,10,89
65485,443,13,14,3066,1000000,1,1083,1983,13,14,27,3,11
65485,443,35,34,8029,1000000,1,2664,5365,35,34,69,6,29
65485,443,40,40,9116,1000000,1,3061,6055,40,40,80,7,33
65485,443,37,36,8426,1000000,1,2887,5539,37,36,73,7,30
65485,443,72,70,17146,1000000,1,5206,11940,72,70,142,10,63
65485,443,77,76,18890,1000000,1,4412,14478,77,76,153,2,75
65485,443,100,100,24560,1000000,1,5575,18985,100,100,200,1,99
65485,443,118,118,28365,1000000,1,7480,20885,118,118,236,8,110
65485,443,117,116,27550,1000000,1,8200,19350,117,116,233,14,103
65485,443,114,114,27633,1000000,1,7244,20389,114,114,228,8,107
65485,443,108,109,25664,1000000,1,7670,17994,108,109,217,14,96
65485,443,84,85,20468,1000000,1,5088,15380,84,85,169,4,81
65485,443,117,116,27994,1000000,1,7716,20278,117,116,233,10,107
65485,443,97,97,24015,1000000,1,5631,18384,97,97,194,3,94
65485,443,87,87,20912,1000000,1,5484,15428,87,87,174,6,81
65485,443,109,105,26234,1000000,1,7847,18387,109,105,214,15,94
65485,443,100,100,23641,1000000,1,6682,16959,100,100,200,10,90
65485,443,107,107,26499,1000000,1,6195,20304,107,107,214,3,104
65485,443,99,99,23642,1000000,1,6259,17383,99,99,198,7,92
65485,443,106,107,25622,1000000,1,7284,18338,106,107,213,12,96
65485,443,116,119,28797,1000000,1,7519,21278,116,119,235,9,110
65485,443,85,83,20156,1000000,1,5606,14550,85,83,168,8,77
65485,443,55,54,12960,1000000,1,3629,9331,55,54,109,5,50
65485,443,93,94,22786,1000000,1,5947,16839,93,94,187,7,87
65485,443,103,102,25091,1000000,1,6626,18465,103,102,205,8,95
65485,443,96,96,23336,1000000,1,5958,17378,96,96,192,6,91
65485,443,90,87,21375,1000000,1,6154,15221,90,87,177,10,80
65485,443,101,101,24531,1000000,1,6646,17885,101,101,202,8,94
65485,443,93,95,23401,1000000,1,5888,17513,93,95,188,6,89
65485,443,100,101,24825,1000000,1,6567,18258,100,101,201,9,92
65485,443,107,108,26927,1000000,1,6116,20811,107,108,215,2,106
65485,443,78,78,18552,1000000,1,4986,13566,78,78,156,6,72
65485,443,95,96,23282,1000000,1,5555,17727,95,96,191,3,93
65485,443,114,114,27999,1000000,1,6724,21275,114,114,228,4,110
65485,443,93,92,22214,1000000,1,6074,16140,93,92,185,8,85
65485,443,78,77,18175,1000000,1,5494,12681,78,77,155,10,68
65485,443,107,107,26410,1000000,1,6799,19611,107,107,214,7,101
65485,443,102,102,24997,1000000,1,5774,19223,102,102,204,2,100
65485,443,98,98,24386,1000000,1,5352,19034,98,98,196,0,98
65485,443,87,88,20114,1000000,1,6508,13606,87,88,175,14,74
65485,443,94,95,22585,1000000,1,6116,16469,94,95,189,8,87
65485,443,100,100,24588,1000000,1,6325,18263,100,100,200,7,94
65485,443,109,109,27807,1000000,1,7192,20615,109,109,218,10,102
65485,443,96,97,23220,1000000,1,6006,17214,96,97,193,6,91
65485,443,66,66,15696,1000000,1,4199,11497,66,66,132,5,61
65485,443,30,30,6960,1000000,1,2140,4820,30,30,60,4,26
65485,443,42,42,9696,1000000,1,3042,6654,42,42,84,6,36
65485,443,30,30,7068,1000000,1,2013,5055,30,30,60,3,27
65485,443,32,31,7464,1000000,1,1982,5482,32,31,63,2,29
65485,443,49,51,11034,1000000,1,4297,6737,49,51,100,13,38
65485,443,119,120,28316,1000000,1,8113,20203,119,120,239,13,107
65485,443,110,111,26869,1000000,1,6623,20246,110,111,221,5,106
65485,443,96,96,24200,1000000,1,5601,18599,96,96,192,3,93
65485,443,99,99,23707,1000000,1,6235,17472,99,99,198,7,92
65485,443,90,89,21745,1000000,1,5253,16492,90,89,179,3,86
65485,443,109,110,26209,1000000,1,7192,19017,109,110,219,10,100
65485,443,102,103,25072,1000000,1,6270,18802,102,103,205,6,97
65485,443,104,105,25294,1000000,1,6561,18733,104,105,209,7,98
65485,443,110,110,27119,1000000,1,6377,20742,110,110,220,3,107
65485,443,99,99,25405,1000000,1,5593,19812,99,99,198,1,98
65485,443,106,103,24922,1000000,1,7670,17252,106,103,209,14,92
65485,443,130,127,31464,1000000,1,8763,22701,130,127,257,13,117
65485,443,122,123,29685,1000000,1,7914,21771,122,123,245,10,114
65485,443,114,110,27587,1000000,1,8006,19581,114,110,224,14,100
65485,443,94,93,22663,1000000,1,5735,16928,94,93,187,5,89
65485,443,95,97,23124,1000000,1,5650,17474,95,97,192,4,92
65485,443,128,127,30691,1000000,1,8608,22083,128,127,255,12,117
65485,443,86,86,20768,1000000,1,5176,15592,86,86,172,4,82
65485,443,108,108,26518,1000000,1,6269,20249,108,108,216,3,105
65485,443,115,114,27743,1000000,1,7270,20473,115,114,229,8,107
65485,443,87,89,20646,1000000,1,6143,14503,87,89,176,11,78
65485,443,104,104,24999,1000000,1,6644,18355,104,104,208,8,97
65485,443,97,96,23527,1000000,1,5885,17642,97,96,193,5,92
65485,443,101,100,24182,1000000,1,6506,17676,101,100,201,8,92
65485,443,40,40,9451,1000000,1,2922,6529,40,40,80,6,35
65485,443,27,27,6255,1000000,1,2129,4126,27,27,54,5,22
65485,443,36,33,7853,1000000,1,3353,4500,36,33,69,11,25
65485,443,96,95,22600,1000000,1,7379,15221,96,95,191,16,82
65485,443,111,112,26675,1000000,1,7594,19081,111,112,223,12,102
65485,443,100,100,24330,1000000,1,5932,18398,100,100,200,4,96
65485,443,131,130,31887,1000000,1,8369,23518,131,130,261,9,122
65485,443,115,115,27714,1000000,1,7044,20670,115,115,230,6,109
65485,443,85,85,20419,1000000,1,5249,15170,85,85,170,5,80
65485,443,110,108,26468,1000000,1,6992,19476,110,108,218,8,102
65485,443,111,110,26441,1000000,1,7542,18899,111,110,221,12,99
65485,443,101,100,24409,1000000,1,6137,18272,101,100,201,5,96
65485,443,103,103,25050,1000000,1,5979,19071,103,103,206,3,100
65485,443,74,74,17676,1000000,1,4643,13033,74,74,148,5,69
65485,443,96,98,22664,1000000,1,7101,15563,96,98,194,15,84
65485,443,93,95,22476,1000000,1,6213,16263,93,95,188,9,86
65485,443,95,96,22506,1000000,1,6424,16082,95,96,191,10,86
65485,443,113,114,27770,1000000,1,6495,21275,113,114,227,3,110
65485,443,110,109,26699,1000000,1,7603,19096,110,109,219,13,99
65485,443,93,94,22326,1000000,1,5923,16403,93,94,187,7,87
65485,443,103,101,24619,1000000,1,6487,18132,103,101,204,7,96
65485,443,142,141,34194,1000000,1,9125,25069,142,141,283,11,131
65485,443,81,82,19513,1000000,1,5041,14472,81,82,163,5,77
65485,443,94,95,23115,1000000,1,5723,17392,94,95,189,5,90
65485,443,113,115,27510,1000000,1,7075,20435,113,115,228,7,108
65485,443,115,117,27553,1000000,1,8088,19465,115,117,232,14,104
65485,443,114,112,26632,1000000,1,8188,18444,114,112,226,16,98
65485,443,108,108,26203,1000000,1,6630,19573,108,108,216,6,102
65485,443,62,62,15092,1000000,1,3658,11434,62,62,124,2,60
65485,443,100,99,23791,1000000,1,6416,17375,100,99,199,8,92
65485,443,106,107,25980,1000000,1,6625,19355,106,107,213,7,100
65485,443,120,121,29478,1000000,1,7707,21771,120,121,241,9,112
65485,443,102,103,24723,1000000,1,6735,17988,102,103,205,9,94
65485,443,137,135,32222,1000000,1,9998,22224,137,135,272,20,117
65485,443,110,110,26175,1000000,1,7381,18794,110,110,220,11,100
65485,443,97,95,23447,1000000,1,6266,17181,97,95,192,8,89
65485,443,76,76,18710,1000000,1,4370,14340,76,76,152,2,74
65485,443,85,85,20642,1000000,1,5027,15615,85,85,170,3,82
65485,443,108,108,25513,1000000,1,7253,18260,108,108,216,11,97
65485,443,114,116,28579,1000000,1,7034,21545,114,116,230,6,110
65485,443,112,112,26821,1000000,1,7088,19733,112,112,224,8,104
65485,443,101,100,24626,1000000,1,5998,18628,101,100,201,4,97
65485,443,96,96,23296,1000000,1,6085,17211,96,96,192,7,89
65485,443,106,106,25620,1000000,1,6927,18693,106,106,212,9,97
65485,443,110,110,26937,1000000,1,6413,20524,110,110,220,3,107
65485,443,95,95,23178,1000000,1,5408,17770,95,95,190,2,93
65485,443,101,101,24439,1000000,1,6113,18326,101,101,202,5,96
65485,443,131,128,32004,1000000,1,8516,23488,131,128,259,10,121
65485,443,104,104,24957,1000000,1,6922,18035,104,104,208,10,95
65485,443,130,129,31581,1000000,1,9018,22563,130,129,259,14,117
65485,443,109,108,26159,1000000,1,7053,19106,109,108,217,9,100
65485,443,90,89,21355,1000000,1,5900,15455,90,89,179,8,82
65485,443,97,96,23053,1000000,1,6254,16799,97,96,193,8,89
65485,443,112,111,26890,1000000,1,6985,19905,112,111,223,7,104
65485,443,120,120,29225,1000000,1,7810,21415,120,120,240,10,111
65485,443,109,110,27284,1000000,1,6859,20425,109,110,219,7,103
65485,443,101,102,24084,1000000,1,6939,17145,101,102,203,11,91
65485,443,107,105,25522,1000000,1,7084,18438,107,105,212,10,97
65485,443,104,105,25458,1000000,1,6450,19008,104,105,209,6,99
65485,443,91,90,21957,1000000,1,5605,16352,91,90,181,5,86
65485,443,49,49,12178,1000000,1,3039,9139,49,49,98,3,46
65485,443,45,43,10240,1000000,1,3617,6623,45,43,88,9,36
65485,443,41,41,9126,1000000,1,3369,5757,41,41,82,9,32
65485,443,48,48,11497,1000000,1,3112,8385,48,48,96,4,44
65485,443,82,82,19903,1000000,1,5087,14816,82,82,164,5,78
65485,443,40,39,8946,1000000,1,3188,5758,40,39,79,8,32
65485,443,29,29,6283,1000000,1,2721,3562,29,29,58,9,20
65485,443,35,34,7833,1000000,1,2918,4915,35,34,69,8,27
65485,443,35,33,7911,1000000,1,2835,5076,35,33,68,7,28
65485,443,34,32,7653,1000000,1,2761,4892,34,32,66,7,27
65485,443,35,35,8232,1000000,1,2549,5683,35,35,70,5,30
65485,443,33,32,7309,1000000,1,2798,4511,33,32,65,8,25
65485,443,86,86,20958,1000000,1,5248,15710,86,86,172,4,82
65485,443,121,119,29649,1000000,1,7051,22598,121,119,240,3,118
65485,443,96,96,22861,1000000,1,6435,16426,96,96,192,9,87
65485,443,107,104,24994,1000000,1,7993,17001,107,104,211,17,91
65485,443,97,98,23571,1000000,1,6056,17515,97,98,195,6,92
65485,443,96,95,22568,1000000,1,6625,15943,96,95,191,11,86
65485,443,104,104,24938,1000000,1,6700,18238,104,104,208,8,97
65485,443,89,88,22331,1000000,1,5096,17235,89,88,177,2,88
65485,443,95,96,23813,1000000,1,5369,18444,95,96,191,1,95
65485,443,80,80,19286,1000000,1,4967,14319,80,80,160,5,75
65485,443,84,83,19639,1000000,1,5806,13833,84,83,167,10,74
65485,443,97,97,23496,1000000,1,6044,17452,97,97,194,6,91
65485,443,31,30,7033,1000000,1,2617,4416,32,31,63,7,24
65485,443,46,41,10356,1000000,1,4606,5750,47,42,89,14,32
65485,443,36,36,8457,1000000,1,2591,5866,36,36,72,5,31
65485,443,41,41,9330,1000000,1,3103,6227,41,41,82,7,34
65485,443,45,44,10084,1000000,1,3700,6384,45,44,89,10,35
65485,443,103,103,24739,1000000,1,6499,18240,103,103,206,7,96
65485,443,83,83,20262,1000000,1,4796,15466,83,83,166,2,81
65485,443,97,96,23469,1000000,1,5965,17504,97,96,193,5,92
65485,443,95,90,22749,1000000,1,5789,16960,95,90,185,5,89
65485,443,124,123,30438,1000000,1,8324,22114,124,123,247,12,113
65485,443,110,109,27286,1000000,1,7199,20087,110,109,219,9,102
65485,443,128,128,31836,1000000,1,7143,24693,128,128,256,1,127
65485,443,123,124,30469,1000000,1,7623,22846,123,124,247,7,117
65485,443,119,119,29755,1000000,1,7181,22574,119,119,238,5,114
65485,443,103,105,24906,1000000,1,6626,18280,103,105,208,8,97
65485,443,118,118,28461,1000000,1,7770,20691,118,118,236,10,109
65485,443,117,120,29036,1000000,1,7382,21654,117,120,237,8,113
65485,443,92,89,22066,1000000,1,6294,15772,92,89,181,10,82
65485,443,85,85,20807,1000000,1,5420,15387,85,85,170,6,79
65485,443,97,96,22977,1000000,1,6413,16564,97,96,193,9,88
65485,443,86,87,20510,1000000,1,6006,14504,86,87,173,10,78
65485,443,105,105,25327,1000000,1,6468,18859,105,105,210,6,99
65485,443,78,77,18716,1000000,1,5264,13452,78,77,155,8,70
65485,443,115,116,30165,1000000,1,6763,23402,115,116,231,3,112
65485,443,94,94,23407,1000000,1,5541,17866,94,94,188,3,91
65485,443,87,87,20718,1000000,1,5659,15059,87,87,174,7,80
65485,443,87,87,20815,1000000,1,5841,14974,87,87,174,9,79
65485,443,99,100,24181,1000000,1,6144,18037,99,100,199,6,94
65485,443,80,80,19569,1000000,1,4654,14915,80,80,160,2,78
65485,443,82,82,19913,1000000,1,4833,15080,82,82,164,3,79
65485,443,94,93,22298,1000000,1,6172,16126,94,93,187,8,86
65485,443,116,113,28127,1000000,1,7412,20715,116,113,229,8,108
65485,443,125,126,31356,1000000,1,7629,23727,125,126,251,5,121
65485,443,101,101,24719,1000000,1,7011,17708,101,101,202,11,91
65485,443,120,119,29100,1000000,1,8045,21055,120,119,239,11,109
65485,443,113,112,28315,1000000,1,6460,21855,113,112,225,2,111
65485,443,88,90,22058,1000000,1,5030,17028,88,90,178,2,88
65485,443,81,79,19510,1000000,1,5275,14235,81,79,160,7,74
65485,443,92,93,23267,1000000,1,5707,17560,92,93,185,5,88
65485,443,108,108,26424,1000000,1,7286,19138,108,108,216,10,99
65485,443,112,110,27424,1000000,1,7402,20022,112,110,222,10,104
65485,443,67,67,16495,1000000,1,3757,12738,67,67,134,1,66
65485,443,74,73,17578,1000000,1,5195,12383,74,73,147,9,66
65485,443,51,50,11328,1000000,1,4175,7153,51,50,101,11,40
65485,443,35,35,8178,1000000,1,2398,5780,35,35,70,4,31
65485,443,36,35,8047,1000000,1,2960,5087,36,35,71,8,28
65485,443,29,27,6272,1000000,1,2709,3563,29,27,56,9,20
65485,443,21,21,4626,1000000,1,1769,2857,21,21,42,5,16
65485,443,90,90,22091,1000000,1,5933,16158,90,90,180,7,84
65485,443,112,110,26985,1000000,1,7239,19746,112,110,222,9,103
65485,443,98,98,24417,1000000,1,5686,18731,98,98,196,2,97
65485,443,110,109,27093,1000000,1,7028,20065,110,109,219,8,103
65485,443,85,85,20965,1000000,1,5297,15668,85,85,170,5,80
65485,443,46,44,10564,1000000,1,3766,6798,46,44,90,10,36
65485,443,33,31,7517,1000000,1,2671,4846,33,31,64,7,26
65485,443,53,52,12089,1000000,1,4188,7901,53,52,105,10,43
65485,443,42,42,9416,1000000,1,3665,5751,42,42,84,11,32
65485,443,30,30,7273,1000000,1,1874,5399,30,30,60,2,28
65485,443,31,31,7531,1000000,1,1940,5591,31,31,62,2,29
65485,443,38,38,8376,1000000,1,3195,5181,38,38,76,9,29
65485,443,34,32,7622,1000000,1,2864,4758,34,32,66,8,26
65485,443,32,31,7303,1000000,1,2363,4940,32,31,63,5,27
65485,443,53,53,11715,1000000,1,4767,6948,53,53,106,15,39
65485,443,39,38,8948,1000000,1,3261,5687,39,38,77,9,31
65485,443,39,40,9050,1000000,1,3376,5674,39,40,79,10,31
65485,443,36,35,8179,1000000,1,2857,5322,36,35,71,7,29
65485,443,45,45,10231,1000000,1,3597,6634,45,45,90,9,36
65485,443,44,42,9918,1000000,1,3690,6228,44,42,86,10,34
65485,443,34,35,7908,1000000,1,2598,5310,34,35,69,6,29
65485,443,48,48,10620,1000000,1,3989,6631,48,48,96,11,37
65485,443,41,41,8898,1000000,1,3611,5287,41,41,82,11,30
65485,443,53,52,12797,1000000,1,3775,9022,53,52,105,7,46
65485,443,60,56,13999,1000000,1,4776,9223,60,56,116,12,48
65485,443,47,47,11274,1000000,1,2955,8319,47,47,94,3,44
65485,443,48,47,12049,1000000,1,3299,8750,48,47,95,5,43
65485,443,44,42,10426,1000000,1,3404,7022,44,42,86,8,37
65485,443,44,44,9768,1000000,1,3670,6098,44,44,88,10,34
65485,443,37,36,8444,1000000,1,2792,5652,37,36,73,6,31
65485,443,42,42,9384,1000000,1,3435,5949,42,42,84,9,33
65485,443,40,39,8948,1000000,1,3303,5645,40,39,79,9,31
65485,443,48,47,10739,1000000,1,4033,6706,48,47,95,11,37
65485,443,38,37,8785,1000000,1,2941,5844,38,37,75,7,31
65485,443,90,91,22657,1000000,1,5345,17312,90,91,181,3,88
65485,443,45,45,10561,1000000,1,3153,7408,45,45,90,5,40
65485,443,101,100,24175,1000000,1,6709,17466,101,100,201,9,92
65485,443,150,150,36163,1000000,1,10099,26064,150,150,300,13,138
65485,443,117,117,29805,1000000,1,7419,22386,117,117,234,7,111
65485,443,102,100,24656,1000000,1,6493,18163,102,100,202,7,95
65485,443,80,78,18710,1000000,1,5590,13120,80,78,158,10,70
65485,443,91,91,21924,1000000,1,5724,16200,91,91,182,6,85
65485,443,109,109,25927,1000000,1,7653,18274,109,109,218,13,97
65485,443,113,112,27460,1000000,1,7965,19495,113,112,225,13,100
65485,443,70,70,17717,1000000,1,3812,13905,70,70,140,0,70
65485,443,92,91,22390,1000000,1,6017,16373,92,91,183,7,85
65485,443,110,107,26019,1000000,1,7639,18380,110,107,217,13,97
65485,443,106,101,25424,1000000,1,7130,18294,106,101,207,10,96
65485,443,106,106,25981,1000000,1,6634,19347,106,106,212,6,101
65485,443,149,145,35977,1000000,1,10437,25540,149,145,294,17,133
65485,443,102,99,24100,1000000,1,7171,16929,102,99,201,13,90
65485,443,78,74,18518,1000000,1,4974,13544,78,74,152,6,72
65485,443,84,83,21249,1000000,1,5001,16248,84,83,167,3,81
65485,443,111,111,27650,1000000,1,6297,21353,111,111,222,1,110
65485,443,98,99,23729,1000000,1,6090,17639,98,99,197,6,93
65485,443,108,109,26588,1000000,1,7155,19433,108,109,217,9,101
65485,443,96,96,24164,1000000,1,5919,18245,96,96,192,5,92
65485,443,92,91,22499,1000000,1,6183,16316,92,91,183,9,84
65485,443,25,23,5666,1000000,1,2444,3222,26,24,50,8,18
65485,443,37,37,8562,1000000,1,2633,5929,37,37,74,5,32
65485,443,53,51,11680,1000000,1,4664,7016,53,51,104,14,39
65485,443,42,40,9901,1000000,1,2788,7113,42,40,82,4,38
65485,443,50,48,11732,1000000,1,3776,7956,50,48,98,8,43
65485,443,50,49,11642,1000000,1,3855,7787,50,49,99,9,42
65485,443,62,60,15126,1000000,1,4166,10960,62,60,122,6,56
65485,443,51,51,12414,1000000,1,3092,9322,51,51,102,2,49
65485,443,49,48,11638,1000000,1,3476,8162,49,48,97,6,43
65485,443,59,58,13699,1000000,1,4663,9036,59,58,117,11,48
65485,443,41,37,8996,1000000,1,3496,5500,41,37,78,10,31
65485,443,53,51,11818,1000000,1,5033,6785,53,51,104,17,38
65485,443,49,47,11313,1000000,1,3801,7512,49,47,96,9,40
65485,443,47,47,11058,1000000,1,3209,7849,47,47,94,5,42
65485,443,40,41,9438,1000000,1,3073,6365,40,41,81,7,34
65485,443,31,31,7001,1000000,1,2321,4680,31,31,62,5,26
65485,443,28,28,6499,1000000,1,2274,4225,28,28,56,6,23
65485,443,55,52,12292,1000000,1,4760,7532,55,52,107,14,41
65485,443,34,33,7615,1000000,1,2749,4866,34,33,67,7,27
65485,443,42,40,9362,1000000,1,3538,5824,42,40,82,10,32
65485,443,99,96,23403,1000000,1,6466,16937,99,96,195,8,90
65485,443,108,109,26510,1000000,1,7123,19387,108,109,217,9,101
65485,443,43,41,9921,1000000,1,3767,6154,43,41,84,11,33
65485,443,28,27,6673,1000000,1,2044,4629,28,27,55,4,24
65485,443,28,28,6810,1000000,1,1766,5044,28,28,56,2,26
65485,443,31,30,7273,1000000,1,2206,5067,31,30,61,4,27
65485,443,41,41,9402,1000000,1,3369,6033,41,41,82,9,32
65485,443,32,32,7008,1000000,1,2744,4264,32,32,64,8,24
65485,443,50,49,11059,1000000,1,4224,6835,50,49,99,12,38
65485,443,48,46,10550,1000000,1,4279,6271,48,46,94,13,35
65485,443,40,39,9498,1000000,1,3081,6417,40,39,79,7,33
65485,443,31,31,7302,1000000,1,2055,5247,31,31,62,3,28
65485,443,39,38,8905,1000000,1,3007,5898,39,38,77,7,32
65485,443,33,32,7538,1000000,1,2314,5224,33,32,65,4,28
65485,443,37,37,8833,1000000,1,2657,6176,37,37,74,5,33
65485,443,28,27,6727,1000000,1,1766,4961,28,27,55,2,26
65485,443,51,49,11169,1000000,1,4532,6637,51,49,100,14,37
65485,443,34,34,7716,1000000,1,2598,5118,34,34,68,6,28
65485,443,46,44,10687,1000000,1,3373,7314,46,44,90,7,39
65485,443,80,79,19422,1000000,1,4586,14836,80,79,159,2,77
65485,443,92,93,22927,1000000,1,5294,17633,92,93,185,2,91
65485,443,103,102,26092,1000000,1,6226,19866,103,102,205,4,99
65485,443,75,74,17869,1000000,1,4824,13045,75,74,149,6,69
65485,443,91,92,21878,1000000,1,5839,16039,91,92,183,7,85
65485,443,97,96,23965,1000000,1,6199,17766,97,96,193,7,90
65485,443,77,76,18187,1000000,1,5325,12862,77,76,153,9,68
65485,443,75,75,18521,1000000,1,4499,14022,75,75,150,3,72
65485,443,85,84,21467,1000000,1,5376,16091,85,84,169,6,79
65485,443,44,44,10513,1000000,1,3162,7351,44,44,88,6,38
65485,443,34,33,7891,1000000,1,2483,5408,34,33,67,5,29
65485,443,31,31,6978,1000000,1,2436,4542,31,31,62,6,25
65485,443,34,34,7435,1000000,1,3233,4202,34,34,68,11,24
65485,443,22,19,4713,1000000,1,2397,2316,23,20,43,9,13
65485,443,35,32,7262,1000000,1,3734,3528,36,33,69,14,21
65485,443,28,26,6134,1000000,1,2528,3606,28,26,54,8,20
65485,443,36,32,7823,1000000,1,3365,4458,36,32,68,11,25
65485,443,29,28,6216,1000000,1,2582,3634,29,28,57,8,21
65485,443,35,34,7585,1000000,1,3160,4425,35,34,69,10,25
65485,443,24,24,5503,1000000,1,2058,3445,24,24,48,6,19
65485,443,28,27,6207,1000000,1,2401,3806,28,27,55,7,21
65485,443,23,23,5226,1000000,1,1750,3476,23,23,46,4,19
65485,443,52,52,13115,1000000,1,3872,9243,52,52,104,8,45
65485,443,90,90,22606,1000000,1,5496,17110,90,90,180,4,86
65485,443,93,93,22550,1000000,1,6741,15809,93,93,186,13,82
65485,443,96,96,23830,1000000,1,5764,18066,96,96,192,4,93
65485,443,113,110,26892,1000000,1,7722,19170,113,110,223,12,101
65485,443,104,97,24946,1000000,1,7153,17793,104,97,201,11,92
65485,443,80,81,19452,1000000,1,5269,14183,80,81,161,7,74
65485,443,94,86,21637,1000000,1,6724,14913,94,86,180,12,82
65485,443,57,54,13497,1000000,1,4142,9355,57,54,111,8,49
65485,443,95,96,23234,1000000,1,5730,17504,95,96,191,4,92
65485,443,107,106,25968,1000000,1,7116,18852,107,106,213,10,99
65485,443,32,32,7668,1000000,1,1994,5674,32,32,64,2,30
65485,443,32,30,7763,1000000,1,2768,4995,32,30,62,8,24
65485,443,52,51,11101,1000000,1,5118,5983,52,51,103,18,34
65485,443,29,29,6757,1000000,1,2352,4405,29,29,58,6,23
65485,443,30,30,6864,1000000,1,2279,4585,30,30,60,5,25
65485,443,43,40,9627,1000000,1,3751,5876,43,40,83,11,32
65485,443,31,29,7215,1000000,1,2194,5021,31,29,60,4,27
65485,443,17,17,4182,1000000,1,918,3264,17,17,34,0,17
65485,443,25,25,6018,1000000,1,1882,4136,25,25,50,4,21
65485,443,41,39,8911,1000000,1,3635,5276,41,39,80,11,30
65485,443,46,44,10214,1000000,1,4298,5916,46,44,90,14,33
65485,443,63,57,12954,1000000,1,6982,5972,63,57,120,27,36
65485,443,91,91,21124,1000000,1,7141,13983,91,91,182,17,75
65485,443,86,85,21016,1000000,1,5466,15550,86,85,171,6,80
65485,443,86,86,21441,1000000,1,4934,16507,86,86,172,2,85
65485,443,83,84,20546,1000000,1,4633,15913,83,84,167,1,83
65485,443,122,120,30593,1000000,1,8300,22293,122,120,242,12,113
65485,443,114,112,27553,1000000,1,7772,19781,114,112,226,12,103
65485,443,82,82,19866,1000000,1,5429,14437,82,82,164,7,75
65485,443,381,375,91339,307685349,1,25442,65897,381,375,756,35,348
